Gg, Gg, Gs^Fds, Gg, Gg, Gs, Gs, Gs^Fds, Gs^Fds, Gg, Gs^Fds, Gs^Fds, Gs, Gs, Gs, Ha, Ha, Hh, Ha, Ha, Ha, Mm, Ha, Ms, Ms, Ms, Ms^Xm, Ms, Ms^Xm, Ms^Xm, Ms^Xm, Ms, Ms, Ms, Ms, Ms, Ms, Ms, Ms, Ms
Gg, Gg, Gs, Gg, Gs, Gs, Gs^Fds, Gs, Gs^Fds, Gs^Fds, Gs^Fds, Gs^Fds, Gd, Gs, Gs, Gs, Gs, Hh, Gs, Ha, Gs, Hh, Ha, Ha, Ms, Ms, Ms, Ms, Ms, Ms^Xm, Ms^Xm, Ms^Xm, Ms^Xm, Ms^Xm, Ms^Xm, Ms, Ms^Xm, Ms, Ms, Ms
Gs, Gs^Fms, Hh, Hh^Fms, Hh, Gs^Fms, Gs^Fds, Gs^Fds, Gs^Fds, Gs^Fds, Gs^Fds, Gs, Gs, Gd, Gd, Gd, Gs, Gs, Gs, Gs, Gs, Hh, Hh, Ms, Ms, Ms, Ha, Ms, Ms, Ms, Ms, Ms, Ms, Ms, Ms^Xm, Ms, Ms, Ms, Ms, Ms
Hh^Fms, Gs, Hh, Hh^Fms, Hh^Fds, Gs^Fds, Gs^Fds, Gs^Fds, Gs^Fds, Gs^Fds, Gs^Fms, Gg^Fms, Gd, Gd, Gd, Gd, Gd, Gs, Gs, Gs, Gs, Gs, Gs, Ha, Ha, Hh, Hh, Ha, Ha, Ms, Ha, Ha, Ms, Ms^Xm, Ms, Ms, Ms, Ms^Xm, Ms, Ms
Gs^Fds, Hh, Hh, Hh^Fms, Gs^Fds, Gs^Fds, Gs^Fds, Gs^Fds, Gs^Fds, Gs^Fds, Gll, Gll, Re^Em, Re, Re, Re, Rd, Rd, Gll, Re^Vct, Gll^Fds, Gs, Gs, Gs, Gs, Hh, Hh, Ha, Ms, Hh, Hh, Ms, Ms, Ms^Xm, Ms, Ms, Ms, Ms, Ms, Ms
Gs^Fms, Hh^Fms, Hh^Fms, Hh^Fms, Hh^Fms, Hh^Fms, Hh^Fms, Gs^Fds, Hh^Fds, Gs^Fds, Gll, Re^Vct, Rd^Ecf, Rd, Ce, Rd, Rd, Rd, Gll, Gs^Fds, Gs^Fds, Gll^Fds, Gg^Fds, Gg, Gs, Gs, Ha, Ha, Ms, Ms, Ms, Ms, Ms^Xm, Ms^Xm, Ms^Xm, Ms, Ms, Ms, Ms, Ms
Gs^Fds, Gs^Fms, Hh^Fds, Hh^Fms, Hh^Es, Gg^Fms, Hh, Hh^Fds, Hh^Fds, Gll, Re, Rd, Rd, Rd, 3 Ke, Ce, Rd, Rd, Gd, Gll, Re^Fds, Gs^Fds, Gg^Fds, Gg, Gg, Gs, Hh, Ha, Ms, Ms, Ms, Ms, Ms, Ms^Xm, Ms^Xm, Ms^Xm, Ms^Xm, Ms, Ms, Ms
Hh, Hh^Fms, Hh^Fds, Hh^Fms, Hh, Hh, Hh, Hh, Hh, Gs, Re, Rd, Rd, Ce, Ce, Rd^Es, Rd, Re^Ecf, Re, Gll, Re^Vct, Re^Fds, Gs^Es, Gg, Gg^Efm, Hh, Hh, Ms, Ha, Ms, Hh, Ms, Ms, Ms, Ms^Xm, Ms, Ms, Ms^Xm, Ms^Xm, Ms
Hh, Hh^Fds, Hh, Hh, Hh, Gs, Gg, Hh, Re^Vct, Re, Re, Re, Rd, Rd, Re, Re, Re, Re, Gd, Gd, Gs, Gs, Gg, Gg, Gg, Gs, Gs, Ha, Ha, Hh, Hh, Hh^Es, Ms, Ms, Ms, Ms, Hh, Ms^Xm, Ms^Xm, Ms
Gs^Fds, Hh^Fms, Hh^Fms, Hh, Gg^Efm, Gs, Gg, Gs, Gs, Re, Gs, Re^Es, Rd^Vct, Re^Ecf, Re, Re, Re, Gd^Es, Gs, Gs, Gs, Gg, Gg, Gg, Gg, Gs, Gs, Gs, Gs, Hh^Es, Hh, Ha, Ha, Ms, Ms, Ha, Ms, Ms^Xm, Ms^Xm, Ms
Gs^Fds, Gg^Fms, Gs^Fds, Hh, Gg, Gg, Gg, Gg, Gg, Gg, Gs, Gd, Rd, Rd, Gd, Rd, Gd^Es, Gd, Gs, Gs, Gs^Fms, Gg, Gg, Gg, Gg, Gg, Gs, Gs, Gs, Ha, Hh, Ha, Hh, Hh, Hh, Ha, Ms, Ms, Ms^Xm, Mm^Xm
Gs^Fms, Gs^Fms, Gs, Gs, Gg, Gg, Gs^Fds, Gg, Gs^Fds, Gg, Gg, Gs, Gs, Gd, Gg, Gs, Gs, Gs, Gg, Gg, Gg, Gg, Gg, Gg, Gg, Gg, Gg, Gs, Gs, Hh, Ha, Ms, Ms, Ms^Xm, Ms, Ms, Ms, Ms^Xm, Ms^Xm, Ms^Xm
Gs^Fms, Gs^Fms, Gs^Fms, Gg^Fms, Gs^Fms, Gs^Fds, Gs^Fms, Gs^Fms, Gs^Fds, Gg^Em, Gg, Gg, Gg, Gg, Gg, Gg, Gg, Gs, Gg, Gg, Gg, Gg, Gs^Fms, Gs, Gs^Fms, Gg, Gg, Gs, Gs, Ha, Ha, Ms, Ms, Ms, Hh, Ms, Ms, Ms^Xm, Ms^Xm, Ms^Xm
Gs^Fds, Gs^Fms, Gs^Fms, Gs^Fms, Gs^Fms, Gs^Fds, Gs^Fms, Gs^Fms, Gs, Gs^Fds, Gs^Fds, Gg, Gg, Gg, Gs^Fds, Gg, Gg, Gg, Gg, Gg, Gg, Gg, Gs^Em, Gs^Fds, Gs^Fds, Gg, Gg, Gs, Gs, Gs, Hh, Hh, Ha, Ha, Ms, Ms, Ms^Xm, Mm^Xm, Ms^Xm, Ms
Gs^Fds, Gs^Fms, Gs^Fms, Gs^Fms, Gs^Fms, Gg^Em, Gs^Fms, Gs, Gs, Gs^Fds, Gs, Gs, Gg, Gs, Gs^Fds, Gs^Fms, Gs, Gg, Gs^Fms, Gg, Gg, Gs^Fds, Gs^Fds, Gs^Fms, Gg, Gg, Gg, Gg^Efm, Gs, Gs, Hh, Hh, Hh, Ha, Ms, Ms, Ms, Ms, Ms^Xm, Ms^Xm
Gs^Fds, Gs^Fds, Gg, Gg, Gg, Gs^Fds, Gs^Fds, Gs, Gg, Gg, Gg, Gg, Gg, Gs, Gs, Gs^Es, Gs, Gg, Gg, Gg, Gg, Gg, Gg, Gg, Gg, Gg, Gg, Gg, Gs, Gs, Gs, Ha, Ha^Es, Ms, Ms, Ms, Hh, Hh^Vhh, Ms^Xm, Ms^Xm
Gg, Gs^Fds, Gg, Gg, Gg, Gg, Gg, Gg, Gg, Gg, Hh, Gg, Ha, Gg, Gg, Gg, Gg, Gg, Gg, Gg, Gg, Gg, Gg, Gg, Gg, Gg, Gg^Es, Gg, Gg, Gs, Gs, Ha, Hh, Ms, Ms, Ms, Ha, Ms, Ms^Xm, Ms^Xm
Gg, Gg, Gg, Gg, Gg, Gg, Gg, Gg, Gs^Fds, Hh, Hh^Fds, Ha, Ha, Hh^Fds, Gs^Fms, Gg, Gg, Gg, Gs^Fds, Gs^Fms, Gs, Gg, Gg, Gg, Gg, Gs^Fds, Gs^Fds, Gs^Fds, Gg, Gs, Gs, Hh, Ha, Hh, Ha, Ha, Ms, Ms^Xm, Ms^Xm, Ms
Hh^Fds, Gg, Gg, Gg, Gg, Gg, Gg, Gs^Fds, Gs^Fms, Gs^Fms, Gs^Fds, Hh, Hh, Hh^Fds, Gg, Gg, Gg, Gg, Gs, Gs, Gs, Gg, Gg, Gg^Efm, Gg, Gg, Gg, Gg, Gg, Gs, Gs, Gs, Gs, Ha, Hh, Ha, Hh, Ms, Ms, Ms^Xm
Ha, Ha, Gs, Gg, Ha, Gg, Gg, Gs^Fds, Gs^Fms, Gs^Fms, Gs, Gs^Fds, Gs^Fds, Gg, Gg, Gg, Gg, Gs, Gs, Gs, Gs^Fds, Gs, Re^Fds, Gg, Gg, Gg, Gs^Fds, Gg, Gg, Gg, Gs, Gs, Gs, Hh, Hh, Ha, Ha, Hh, Ms, Ms
Hh, Ha, Hh, Ha, Hh^Fms, Hh^Fds, Gg, Gg^Em, Gs^Fms, Gs, Gs, Gs^Fds, Gs, Gs, Gg, Gg, Gg, Gs, Gs^Fds, Gs^Fds, Gs^Fms, Gs, Re^Fds, Gg^Es, Re^Fds, Gg, Gs^Fds, Gg, Gg, Gs, Gs, Gs, Gs, Gs, Gs, Ha, Ha, Hh, Hh, Ms
Hh, Hh, Hh, Hh, Hh^Fms, Hh, Gg, Gs^Fds, Gs^Fds, Gs, Gg, Gg, Gg, Gs, Gg, Gg, Gg, Gg, Gg, Gs^Fds, Gs^Fds, Gs^Fds, Gs^Fds, Re^Fds, Gg^Fms, Gg, Gg, Gg, Gg, Gg, Gs, Gs, Gs, Gs, Gs, Hh, Ha, Ha, Ha, Ms
Ha, Ha, Hh^Fms, Hh^Fds, Hh^Fds, Hh, Gg, Gg, Gg, Gg, Gg, Gg, Gg, Gg, Ha, Gg^Efm, Hh^Em, Ha, Gs, Gs^Fds, Gs^Em, Gs^Fds, Gs^Fds, Gs^Fms, Gs^Fms, Gg, Gg, Gg, Gg, Gg, Gg, Gs, Gs, Gs, Re, Re, Re, Ha, Ha^Emf, Ha
Ha, Ha, Hh, Hh^Vh, Ha, Ha, Hh, Gg, Gg, Gg, Gg, Gg, Gg, Ha, Ha, Hh, Ha, Hh^Fms, Gg, Gs, Gs^Fds, Gs^Fds, Gs^Fds, Gs^Fds, Gs^Fds, Gg^Fds, Gg^Fds, Gg, Gg, Coa, Re, Gg, Re, Re, Gs, Gs, Gs, Aa^Voa, Wwr, Wwr
Hh, Hh, Hh, Ha, Ha, Hh, Ha^Es, Gg, Gg, Gg, Gg, Gg, Hh, Hh, Hh^Es, Wwf^Es, Ha, Ha, Gg^Fds, Hh^Fms, Gs^Fms, Gs^Fds, Gs^Fds, Gs^Fds, Gs^Fms, Gg^Fds, Gg, Gg, Gg, Gg, Re, Re, Gg, Re, Re, Rb^Gvs, Rb^Gvs, Hh^Emf, Wwr, Ha
Hh, Hh, Ha, Hh, Gg^Fds, Hh^Es, Hh^Fms, Ha, Gg, Gg, Gg, Gg, Ha, Ha, Hh^Fds, Wwf^Es, Gg^Fms, Ha, Hh^Fds, Hh^Fms, Gs^Fds, Gs^Fds, Gg, Aa^Voa, Gs, Gg, Gg, Gg, Re, Re, Wwf, Wwf, Wwf, Rb^Gvs, Rb^Gvs, Rb^Vwm, Ww^Es, Ww^Es, Hh, Ha^Es
Hh, Ha, Hh^Fds, Gg^Fms, Gg^Fds, Gs^Fds, Ha^Fms, Hh^Fms, Gs, Gg, Gg, Gg^Efm, Hh, Hh^Fds, Ha^Es, Wwf^Es, Wwf^Es, Ha, Ha, Gs^Fds, Gg^Fds, Gg^Fms, Coa, Re, Re, Gg, Gg, Gg, Re, Rb^Gvs, Gg, Hh, Wwf, Rb^Gvs, Ww, Ww^Es, Hh, Ha, Ha, Hh
Hh, Hh, Gg^Fms, Gg^Fds, Gg^Fms, Gs^Fds, Ha^Fds, Ha^Fds, Hh^Fds, Gs, Gg, Gg, Gg, Ha, Ha, Ha, Gg^Fds, Ww^Es, Ha, Gg^Fds, Gg^Fds, 1 Koa, Coa, Gg, Gs, Re, Re, Gg, Re, Gg, Gg, Rb^Gvs, Aa, Ww, Aa, Rb^Gvs, Hh, Ha, Hh, Hh
Ha, Ha, Ha^Fet, Gg^Fms, Gg^Fms, Gg^Fms, Gg^Fds, Gs, Gs, Gs, Gg, Gg, Gg, Gg, Gg^Efm, Hh, Ha^Emf, Ww^Es, Ww, Gg, Gg, Coa, Gg, Gg, Gg, Gs, Re, Re, Coa, Rb, Rb, Aa^Voa, Ww, Ww, Re, Aa^Voa, Hh, Hh, Ha^Edt, Ms
Hh, Ha, Hh, Ha, Hh^Fds, Gg^Fms, Gg^Fds, Gg^Fms, Gs, Gs, Gg, Gg, Gg, Gg, Re, Aa^Voa, Hh, Hh, Rb^Gvs, Ww, Ww, Gg, Rb^Gvs, Aa^Voa, Re, Re, Coa, 2 Koa, Ww, Ww, Ww, Ww^Bw\, Ww^Bw\, Rb, Aa, Ha, Gll^Fp, Ha, Ms, Ms
Hh, Hh, Hh^Fms, Ha, Ha, Hh^Fds, Hh, Gs, Gs, Gs, Gg, Gg, Coa, Gg, Re, Gg, Gg, Gg^Efm, Aa^Voa, Rb^Gvs, Gg, Ww, Ww^Bw/, Rb, Re^Gvs, Rb, Coa, Ww, Ww, Ww, Ww, Ww, Rb, Rb, Ha, Hh^Fp, Gll^Fp, Ms, Ms^Xm, Ms
Hh, Hh^Fds, Hh, Ha, Hh, Hh, Ha, Gg^Fds, Hh, Gs, Gg, Gg, Gg, Re, Gg, Gg, Gg, Gg, Re, Gg, Re, Rb, Gg, Ww, Re^Es, Ww, Ww, Ww, Wot, Ww, Ww, Ww, Aa^Voa, Aa^Em, Hh^Fp, Hh^Fms, Ha, Ms, Ms, Ms
Ha, Ha, Gg^Efm, Gg^Efm, Hh^Fms, Hh, Ha^Fet, Ha, Hh^Fds, Gs, Gs, Gg, Gg^Eff, Re, Re, Gg, Gg, Gg, Re, Re, Gg, Re, Gg, Ww, Ww, Ww, Wot, Wot, Wo, Wot, Wot, Ww, Rb^Gvs, Ha, Hh^Fp, Hh^Fp, Ms^Xm, Ms, Ms, Ms
Hh, Hh, Hh^Fms, Gg^Efm, Hh, Hh, Hh, Ha, Gs, Gs^Efm, Gg^Eff, Gs^Eff, Rd^Gvs, Gg^Eff, Rb^Eff, Re, Rb^Gvs, Re, Gg, Gg, Aa^Voa, Re, Rb, Ww, Ww, Ww, Wot, Wo, Wo, Wot, Wot, Ww, Wwr, Hh^Fp, Hh^Fp, Ms, Ms, Ms, Ms, Ms
Hh, Hh, Ha, Gg, Gg, Gg^Efm, Hh, Hh, Gs^Eff, Gg^Eff, Rd^Gvs, Re^Gvs, Re, Re^Eff, Gg, Ww, Ww, Rb, Ww, Rb^Gvs, Rb^Gvs, Gg, Ww, Ww^Bw\, Rb, Ww, Ww, Wot, Wot, Wo, Ww, Ww, Wwr, Hh^Fp, Hh^Fms, Hh, Ms, Ms, Ms, Ms
Hh, Ha, Ha, Gg, Gg, Gg, Gg, Gs, Gg, Gg^Eff, Gg^Eff, Gg^Eff, Aa^Voa, Gs, Gg, Rb^Gvs, Rb^Gvs, Ww^Bw|, Gg, Ww, Ww, Ww, Ww, Ww, Re^Gvs, Aa^Voa, Gs^Fds, Ww, Ww, Ww, Ww, Ww, Ww, Hh^Fp, Hh^Fp, Hh^Fms, Ms, Ms, Ms, Ms
Ha, Hh^Fds, Hh^Fms, Hh, Hh^Fds, Gg^Es, Gg, Gg, Gg, Gg, Gg, Gg, Gg, Gg, Gg, Gs, Re, Rb, Gg^Fds, Gg^Fds, Wwr, Ww, Ww, Ww, Ww, Gs^Fds, Ww, Gs^Fds, Ww, Ww, Ww, Ww, Ww, Ww^Es, Hh, Hh^Fp, Ms, Ms, Ms, Ms
Hh, Ha, Hh, Hh, Hh, Gg^Es, Gg, Gg, Gg, Gg, Gg, Gg, Gg, Gg, Gg, Re, Re, Gg, Gg^Fds, Gg^Fds, Wwr, Ww, Ww, Ww, Ww, Ww, Ww, Ww, Ww, Ww, Ww, Ww, Ww, Ww, Hh, Ms, Ms, Ms, Ms, Ms
