Gg, Gg, Gs^Fds, Gg, Gg, Gs, Gs, Gs^Fds, Gs^Fds, Gg, Gs^Fds, Gs^Fds, Gs, Gs, Gs, Ha, Ha, Hhd, Ha, Ha, Ha, Hhd, Ha, Ms, Ms, Ms, Ms^Xm, Ms, Ms^Xm, Ms^Xm, Ms^Xm, Ms, Ms, Ms, Ms, Ms, Ms, Ms, Ms, Ms
Gg, Gg, Gs, Gg, Gs, Gs, Gs^Fds, Gs, Gs^Fds, Gs^Fds, Gs^Fds, Gs^Fds, Gd, Gs, Gs, Gs, Gs, Hhd, Gs, Ha, Gs, Hhd, Ha, Ha, Ms, Ms, Ms, Ms, Ms, Ms^Xm, Ms^Xm, Ms^Xm, Ms^Xm, Ms^Xm, Ms^Xm, Ms, Ms^Xm, Ms, Ms, Ms
Gs, Gs^Fms, Hhd, Hhd^Fms, Hhd, Gs^Fms, Gs^Fds, Gs^Fds, Gs^Fds, Gs^Fds, Gs^Fds, Gs, Gs, Gd, Gd, Gd, Gs, Gs, Gs, Gs, Gs, Hhd, Hhd, Ms, Ms, Ms, Ha, Ms, Ms, Ms, Ms, Ms, Ms, Ms, Ms^Xm, Ms, Ms, Ms, Ms, Ms
Hh^Fms, Gs, Hhd, Hhd^Fms, Hhd^Fds, Gs^Fds, Gs^Fds, Gs^Fds, Gs^Fds, Gs^Fds, Gs^Fms, Gg^Fms, Gd, Gd, Gd, Gd, Gd, Gs, Gs, Gs, Gs, Gs, Gs, Ha, Ha, Hhd, Hhd, Ha, Ha, Ms, Hhd, Ha, Ms, Ms^Xm, Ms, Ms, Ms, Ms^Xm, Ms, Ms
Gs^Fds, Hhd, Hhd, Hhd^Fms, Gs^Fds, Gs^Fds, Gs^Fds, Gs^Fds, Gs^Fds, Gs^Fds, Gll, Gll, Re^Em, Re, Re, Re, Rd, Rd, Gll, Re^Vct, Gll^Fds, Gs, Gs, Gs, Gs, Hhd, Hhd, Ha, Ms, Hhd, Hhd, Ms, Ms, Ms^Xm, Ms, Ms, Ms, Ms, Ms, Ms
Gs^Fms, Hhd^Fms, Hhd^Fms, Hhd^Fms, Hhd^Fms, Hhd^Fms, Hhd^Fms, Gs^Fds, Hhd^Fds, Gs^Fds, Gll, Re^Vct, Rd^Ecf, Rd, Cea, Rd, Rd, Rd, Gll, Gs^Fds, Gs^Fds, Gll^Fds, Gg^Fds, Gg, Gs, Gs, Ha, Ha, Ms, Ms, Ms, Ms, Ms^Xm, Ms^Xm, Ms^Xm, Ms, Ms, Ms, Ms, Ms
Gs^Fds, Gs^Fms, Hhd^Fds, Hhd^Fms, Hhd^Es, Gg^Fms, Hhd, Hhd^Fds, Hhd^Fds, Gll, Re, Rd, Rd, Rd, 3 Kea, Cea, Rd, Rd, Gd, Gll, Re^Fds, Gs^Fds, Gg^Fds, Gg, Gg, Gs, Hhd, Ha, Ms, Ms, Ms, Ms, Ms, Ms^Xm, Ms^Xm, Ms^Xm, Ms^Xm, Ms, Ms, Ms
Hhd, Hhd^Fms, Hhd^Fds, Hhd^Fms, Hhd, Hhd, Hhd, Hhd, Hhd, Gs, Re, Rd, Rd, Cea, Cea, Rd^Es, Rd, Re^Ecf, Re, Gll, Re^Vct, Re^Fds, Gs^Es, Gg, Gg^Efm, Hhd, Hhd, Ms, Ha, Ms, Hhd, Ms, Ms, Ms, Ms^Xm, Ms, Ms, Ms^Xm, Ms^Xm, Ms
Hhd, Hhd^Fds, Hhd, Hhd, Hhd, Gs, Gg, Hhd, Re^Vct, Re, Re, Re, Rd, Rd, Re, Re, Re, Re, Gd, Gd, Gs, Gs, Gg, Gg, Gg, Gs, Gs, Ha, Ha, Ha, Hhd, Hhd^Es, Ms, Ms, Ms, Ms, Hhd, Ms^Xm, Ms^Xm, Ms
Gs^Fds, Hhd^Fms, Hhd^Fms, Hhd, Gg^Efm, Gs, Gg, Gs, Gs, Re, Gs, Re^Es, Rd^Vct, Re^Ecf, Re, Re, Re, Gd^Es, Gs, Gs, Gs, Gg, Gg, Gg, Gg, Gs, Gs, Gs, Gs, Hhd^Es, Ha, Ha, Ha, Ms, Ms, Ha, Ms, Ms^Xm, Ms^Xm, Ms
Gs^Fds, Gg^Fms, Gs^Fds, Hhd, Gg, Gg, Gg, Gg, Gg, Gg, Gs, Gd, Rd, Rd, Gd, Rd, Gd^Es, Gd, Gs, Gs, Gs^Fms, Gg, Gg, Gg, Gg, Gg, Gs, Gs, Gs, Ha, Hhd, Ha, Hhd, Hhd, Hhd, Ha, Ms, Ms, Ms^Xm, Mm^Xm
Gs^Fms, Gs^Fms, Gs, Gs, Gg, Gg, Gs^Fds, Gg, Gs^Fds, Gg, Gg, Gs, Gs, Gd, Gg, Gs, Gs, Gs, Gg, Gg, Gg, Gg, Gg, Gg, Gg, Gg, Gg, Gs, Gs, Hhd, Ha, Ms, Ms, Ms^Xm, Ms, Ms, Ms, Ms^Xm, Ms^Xm, Ms^Xm
Gs^Fms, Gs^Fms, Gs^Fms, Gg^Fms, Gs^Fms, Gs^Fds, Gs^Fms, Gs^Fms, Gs^Fds, Gg^Em, Gg, Gg, Gg, Gg, Gg, Gg, Gg, Gs, Gg, Gg, Gg, Gg, Gs^Fms, Gs, Gs^Fms, Gg, Gg, Gs, Gs, Ha, Ha, Ms, Ms, Ms, Hhd, Ms, Ms, Ms^Xm, Ms^Xm, Ms^Xm
Gs^Fds, Gs^Fms, Gs^Fms, Gs^Fms, Gs^Fms, Gs^Fds, Gs^Fms, Gs^Fms, Gs, Gs^Fds, Gs^Fds, Gg, Gg, Gg, Gs^Fds, Gg, Gg, Gg, Gg, Gg, Gg, Gg, Gs^Em, Gs^Fds, Gs^Fds, Gg, Gg, Gs, Gs, Gs, Hhd, Ha, Ha, Hhd, Ms, Ms, Ms^Xm, Mm^Xm, Ms^Xm, Ms
Gs^Fds, Gs^Fms, Gs^Fms, Gs^Fms, Gs^Fms, Gg^Em, Gs^Fms, Gs, Gs, Gs^Fds, Gs, Gs, Gg, Gs, Gs^Fds, Gs^Fms, Gs, Gg, Gs^Fms, Gg, Gg, Gs^Fds, Gs^Fds, Gs^Fms, Gg, Gg, Gg, Gg^Efm, Gs, Gs, Hhd, Hhd, Ha, Ha, Ms, Ms, Ms, Ms, Ms^Xm, Ms^Xm
Gs^Fds, Gs^Fds, Gg, Gg, Gg, Gs^Fds, Gs^Fds, Gs, Gg, Gg, Gg, Gg, Gg, Gs, Gs, Gs^Es, Gs, Gg, Gg, Gg, Gg, Gg, Gg, Gg, Gg, Gg, Gg, Gg, Gs, Gs, Gs, Ha, Ha^Es, Ms, Ms, Ms, Hhd, Hh^Vhh, Ms^Xm, Ms^Xm
Gg, Gs^Fds, Gg, Gg, Gg, Gg, Gg, Gg, Gg, Gg, Hhd, Gg, Ha, Gg, Gg, Gg, Gg, Gg, Gg, Gg, Gg, Gg, Gg, Gg, Gg, Gg, Gg^Es, Gg, Gg, Gs, Gs, Ha, Hhd, Ms, Ms, Ms, Ha, Ms, Ms^Xm, Ms^Xm
Gg, Gg, Gg, Gg, Gg, Gg, Gg, Gg, Gs^Fds, Hhd, Hhd^Fds, Ha, Ha, Hhd^Fds, Gs^Fms, Gg, Gg, Gg, Gs^Fds, Gs^Fms, Gs, Gg, Gg, Gg, Gg, Gs^Fds, Gs^Fds, Gs^Fds, Gg, Gs, Gs, Hhd, Ha, Hhd, Ha, Ha, Ms, Ms^Xm, Ms^Xm, Ms
Hh^Fds, Gg, Gg, Gg, Gg, Gg, Gg, Gs^Fds, Gs^Fms, Gs^Fms, Gs^Fds, Hhd, Hhd, Hhd^Fds, Gg, Gg, Gg, Gg, Gs, Gs, Gs, Gg, Gg, Gg^Efm, Gg, Gg, Gg, Gg, Gg, Gs, Gs, Gs, Gs, Ha, Hhd, Ha, Hhd, Ms, Ms, Ms^Xm
Ha, Ha, Gs, Gg, Ha, Gg, Gg, Gs^Fds, Gs^Fms, Gs^Fms, Gs, Gs^Fds, Gs^Fds, Gg, Gg, Gg, Gg, Gs, Gs, Gs, Gs^Fds, Gs, Re^Fds, Gg, Gg, Gg, Gs^Fds, Gg, Gg, Gg, Gs, Gs, Gs, Hhd, Hhd, Ha, Ha, Hhd, Ms, Ms
Hhd, Ha, Hhd, Ha, Hhd^Fms, Hhd^Fds, Gg, Gg^Em, Gs^Fms, Gs, Gs, Gs^Fds, Gs, Gs, Gg, Gg, Gg, Gs, Gs^Fds, Gs^Fds, Gs^Fms, Gs, Re^Fds, Gg^Es, Re^Fds, Gg, Gs^Fds, Gg, Gg, Gs, Gs, Gs, Gs, Gs, Gs, Hhd, Ha, Hhd, Hhd, Ms
Hhd, Hhd, Hhd, Hhd, Hhd^Fms, Hhd, Gg, Gs^Fds, Gs^Fds, Gs, Gg, Gg, Gg, Gs, Gg, Gg, Gg, Gg, Gg, Gs^Fds, Gs^Fds, Gs^Fds, Gs^Fds, Re^Fds, Gg^Fms, Gg, Gg, Gg, Gg, Gg, Gs, Gs, Gs, Gs, Gs, Hhd, Ha, Ha, Ha, Ms
Ha, Ha, Hhd^Fms, Hhd^Fds, Hhd^Fds, Hhd, Gg, Gg, Gg, Gg, Gg, Gg, Gg, Gg, Ha, Gg^Efm, Hhd^Em, Ha, Gs, Gs^Fds, Gs^Em, Gs^Fds, Gs^Fds, Gs^Fms, Gs^Fms, Gg, Gg, Gg, Gg, Gg, Gg, Gs, Gs, Gs, Re, Re, Re, Ha, Ha^Emf, Ha
Ha, Ha, Hhd, Hhd^Vh, Ha, Ha, Hhd, Gg, Gg, Gg, Gg, Gg, Gg, Ha, Ha, Hhd, Ha, Hhd^Fms, Gg, Gs, Gs^Fds, Gs^Fds, Gs^Fds, Gs^Fds, Gs^Fds, Gg^Fds, Gg^Fds, Gg, Gg, Coa, Re, Gg, Re, Re, Gs, Gs, Gs, Aa^Voa, Wwr, Wwr
Hhd, Hhd, Hhd, Ha, Ha, Hhd, Ha^Es, Gg, Gg, Gg, Gg, Gg, Hhd, Hhd, Hhd^Es, Wwf^Es, Ha, Ha, Gg^Fds, Hhd^Fms, Gs^Fms, Gs^Fds, Gs^Fds, Gs^Fds, Gs^Fms, Gg^Fds, Gg, Gg, Gg, Gg, Re, Re, Gg, Re, Re, Rb^Gvs, Rb^Gvs, Hh^Emf, Wwr, Ha
Hhd, Hhd, Ha, Hhd, Gg^Fds, Hhd^Es, Hhd^Fms, Ha, Gg, Gg, Gg, Gg, Ha, Ha, Hhd^Fds, Wwf^Es, Gg^Fms, Ha, Hhd^Fds, Hhd^Fms, Gs^Fds, Gs^Fds, Gg, Aa^Voa, Gs, Gg, Gg, Gg, Re, Re, Wwf, Wwf, Wwf, Rb^Gvs, Rb^Gvs, Rb^Vwm, Ww^Es, Ww^Es, Hhd, Ha^Es
Hhd, Ha, Hhd^Fds, Gg^Fms, Gg^Fds, Gs^Fds, Ha^Fma, Hhd^Fms, Gs, Gg, Gg, Gg^Efm, Hhd, Hhd^Fds, Ha^Es, Wwf^Es, Wwf^Es, Ha, Ha, Gs^Fds, Gg^Fds, Gg^Fms, Coa, Re, Re, Gg, Gg, Gg, Re, Rb^Gvs, Gg, Hh, Wwf, Rb^Gvs, Ww, Ww^Es, Hhd, Ha, Ha, Hhd
Hhd, Hhd, Gg^Fms, Gg^Fds, Gg^Fms, Gs^Fds, Ha^Fma, Ha^Fpa, Hh^Fds, Gs, Gg, Gg, Gg, Ha, Ha, Ha, Gg^Fds, Ww^Es, Ha, Gg^Fds, Gg^Fds, 1 Koa, Coa, Gg, Gs, Re, Re, Gg, Re, Gg, Gg, Rb^Gvs, Aa, Ww, Aa, Rb^Gvs, Hhd, Ha, Hhd, Hhd
Ha, Ha, Ha^Feta, Gg^Fms, Gg^Fms, Gg^Fms, Gg^Fds, Gs, Gs, Gs, Gg, Gg, Gg, Gg, Gg^Efm, Hhd, Ha^Emf, Ww^Es, Ww, Gg, Gg, Coa, Gg, Gg, Gg, Gs, Re, Re, Coa, Rb, Rb, Aa^Voa, Ai, Ww, Re, Aa^Voa, Hhd, Hhd, Ha^Edt, Ms
Hhd, Ha, Hhd, Ha, Hh^Fds, Gg^Fms, Gg^Fds, Gg^Fms, Gs, Gs, Gg, Gg, Gg, Gg, Re, Aa^Voa, Hhd, Hhd, Rb^Gvs, Ai, Ai, Gg, Rb^Gvs, Aa^Voa, Re, Re, Coa, 2 Koa, Ai, Ww, Ww, Ai^Bw\, Ww^Bw\, Rb, Aa, Ha, Gll^Fp, Ha, Ms, Ms
Hhd, Hhd, Hhd^Fms, Ha, Ha, Hh^Fds, Hhd, Gs, Gs, Gs, Gg, Gg, Coa, Gg, Re, Gg, Gg, Gg^Efm, Aa^Voa, Rb^Gvs, Gg, Ww, Ww^Bw/, Rb, Re^Gvs, Rb, Coa, Ai, Ww, Ww, Ai, Ww, Rb, Rb, Ha, Hhd^Fp, Gll^Fp, Ms, Ms^Xm, Ms
Hhd, Hhd^Fds, Hhd, Ha, Hhd, Hhd, Ha, Gg^Fds, Hhd, Gs, Gg, Gg, Gg, Re, Gg, Gg, Gg, Gg, Re, Gg, Re, Rb, Gg, Ai, Re^Es, Ww, Ww, Ai, Wot, Ww, Ww, Ai, Aa^Voa, Aa^Em, Hhd^Fp, Hhd^Fms, Ha, Ms, Ms, Ms
Ha, Ha, Gg^Efm, Gg^Efm, Hhd^Fms, Hhd, Ha^Feta, Ha, Hhd^Fds, Gs, Gs, Gg, Gg^Eff, Re, Re, Gg, Gg, Gg, Re, Re, Gg, Re, Gg, Ai, Ai, Ww, Wot, Wot, Wo, Wot, Wot, Ai, Rb^Gvs, Ha, Hhd^Fp, Hhd^Fp, Ms^Xm, Ms, Ms, Ms
Hhd, Hhd, Hhd^Fms, Gg^Efm, Hhd, Hhd, Hhd, Ha, Gs, Gs^Efm, Gg^Eff, Gs^Eff, Rd^Gvs, Gg^Eff, Rb^Eff, Re, Rb^Gvs, Re, Gg, Gg, Aa^Voa, Re, Rb, Ww, Ww, Ww, Wot, Wo, Wo, Wot, Wot, Ww, Wwr, Hhd^Fp, Hhd^Fp, Ms, Ms, Ms, Ms, Ms
Hhd, Hhd, Ha, Gg, Gg, Gg^Efm, Hhd, Hhd, Gs^Eff, Gg^Eff, Rd^Gvs, Re^Gvs, Re, Re^Eff, Gg, Ww, Ww, Rb, Ww, Rb^Gvs, Rb^Gvs, Gg, Ww, Ww^Bw\, Rb, Ai, Ai, Wot, Wot, Wo, Ww, Ww, Wwr, Hhd^Fp, Hhd^Fms, Hhd, Ms, Ms, Ms, Ms
Hhd, Ha, Ha, Gg, Gg, Gg, Gg, Gs, Gg, Gg^Eff, Gg^Eff, Gg^Eff, Aa^Voa, Gs, Gg, Rb^Gvs, Rb^Gvs, Ww^Bw|, Gg, Ww, Ww, Ww, Ai, Ww, Re^Gvs, Aa^Voa, Gs^Fds, Ww, Ww, Ww, Ai, Ai, Ww, Hhd^Fp, Hhd^Fp, Hhd^Fms, Ms, Ms, Ms, Ms
Ha, Hhd^Fds, Hhd^Fms, Hhd, Hhd^Fds, Gg^Es, Gg, Gg, Gg, Gg, Gg, Gg, Gg, Gg, Gg, Gs, Re, Rb, Gg^Fds, Gg^Fds, Wwr, Ai, Ai, Ww, Ww, Gs^Fds, Ww, Gs^Fds, Ai, Ww, Ww, Ai, Ww, Ww^Es, Hhd, Hhd^Fp, Ms, Ms, Ms, Ms
Hh, Ha, Hhd, Hhd, Hhd, Gg^Es, Gg, Gg, Gg, Gg, Gg, Gg, Gg, Gg, Gg, Re, Re, Gg, Gg^Fds, Gg^Fds, Wwr, Ww, Ww, Ww, Ww, Ww, Ww, Ww, Ww, Ww, Ww, Ww, Ww, Ww, Hh, Ms, Ms, Ms, Ms, Ms
