Gg, Gg, Gs^Fds, Gg, Gg, Gs, Gs, Gs^Fds, Gs^Fds, Gg, Gs^Fds, Gs^Fds, Gs, Gs, Gs, Hh, Hh, Hh, Hh, Gg, Hh, Mm, Hh, Mm, Mm, Mm, Mm, Mm, Mm, Mm, Mm, Mm, Mm, Mm, Mm, Mm, Mm, Mm, Mm, Mm
Gg, Gg, Gs, Gg, Gs, Gs, Gs^Fds, Gs, Gs^Fds, Gs^Fds, Gs^Fds, Gs^Fds, Gd, Gs, Gs, Gs, Gs, Hh, Gs, Hh, Gs, Hh, Hh, Hh, Mm, Mm, Mm, Mm, Mm, Mm, Mm, Mm, Mm, Mm, Mm, Mm, Mm, Mm, Mm, Mm
Gs, Gs^Fms, Hh, Hh^Fms, Hh, Gs^Fms, Gs^Fds, Gs^Fds, Gs^Fds, Gs^Fds, Gs^Fds, Gs, Gs, Gd, Gd, Gd, Gs, Gs, Gs, Gs, Gs, Hh, Hh, Mm, Mm, Mm, Hh, Mm, Mm, Mm, Mm, Mm, Mm, Mm, Mm, Mm, Mm, Mm, Mm, Mm
Hh^Fms, Gs, Hh, Hh^Fms, Hh^Fds, Gs^Fds, Gs^Fds, Gs^Fds, Gs^Fds, Gs^Fds, Gs^Fms, Gg^Fms, Gd, Gd, Gd, Gd, Gd, Gs, Gs, Gs, Gs, Gs, Gs, Hh, Hh, Hh, Hh, Hh, Hh, Mm, Hh, Hh, Mm, Mm, Mm, Mm, Mm, Mm, Mm, Mm
Gs^Fds, Hh, Hh, Hh^Fms, Gs^Fds, Gs^Fds, Gs^Fds, Gs^Fds, Gs^Fds, Gs^Fds, Gll, Gll, Re^Em, Re, Re, Re, Rd, Rd, Gll, Re^Vct, Gll^Fds, Gs, Gs, Gs, Gs, Hh, Hh, Hh, Mm, Hh, Hh, Mm, Mm, Mm, Mm, Mm, Mm, Mm, Mm, Mm
Gs^Fms, Hh^Fms, Hh^Fms, Hh^Fms, Hh^Fms, Hh^Fms, Hh^Fms, Gs^Fds, Hh^Fds, Gs^Fds, Gll, Re^Vct, Rd^Ecf, Rd, Ce, Rd, Rd, Rd, Gll, Gs^Fds, Gs^Fds, Gll^Fds, Gg^Fds, Gg, Gs, Gs, Hh, Hh, Mm, Mm, Mm, Mm, Mm, Mm, Mm, Mm, Mm, Mm, Mm, Mm
Gs^Fds, Gs^Fms, Hh^Fds, Hh^Fms, Hh^Es, Gg^Fms, Hh, Hh^Fds, Hh^Fds, Gll, Re, Rd, Rd, Rd, Ke, Ce, Rd, Rd, Gd, Gll, Re^Fds, Gs^Fds, Gg^Fds, Gg, Gg, Gs, Hh, Hh, Mm, Mm, Mm, Mm, Mm, Mm, Mm, Mm, Mm, Mm, Mm, Mm
Hh, Hh^Fms, Hh^Fds, Hh^Fms, Hh, Hh, Hh, Hh, Hh, Gs, Re, Rd, Rd, Ce, Ce, Rd^Es, Rd, Re^Ecf, Re, Gll, Re^Vct, Re^Fds, Gs^Es, Gg, Gg^Efm, Hh, Hh, Mm, Hh, Mm, Hh, Mm, Mm, Mm, Mm, Mm, Mm, Mm, Mm, Mm
Hh, Hh^Fds, Hh, Hh, Hh, Gs, Gg, Hh, Re^Vct, Re, Re, Re, Rd, Rd, Re, Re, Re, Re, Gd, Gd, Gs, Gs, Gg, Gg, Gg, Gs, Gs, Hh, Hh, Hh, Hh, Hh^Es, Mm, Mm, Mm, Mm, Hh, Mm, Mm, Mm
Gs^Fds, Hh^Fms, Hh^Fms, Hh, Gg^Efm, Gs, Gg, Gs, Gs, Re, Gs, Re^Es, Rd^Vct, Re^Ecf, Re, Re, Re, Gd^Es, Gs, Gs, Gs, Gg, Gg, Gg, Gg, Gs, Gs, Gs, Gs, Hh^Es, Hh, Hh, Hh, Mm, Mm, Hh, Mm, Mm, Mm, Mm
Gs^Fds, Gg^Fms, Gs^Fds, Hh, Gg, Gg, Gg, Gg, Gg, Gg, Gs, Gd, Rd, Rd, Gd, Rd, Gd^Es, Gd, Gs, Gs, Gs^Fms, Gg, Gg, Gg, Gg, Gg, Gs, Gs, Gs, Hh, Hh, Hh, Hh, Hh, Hh, Hh, Mm, Mm, Mm^Xm, Mm^Xm
Gs^Fms, Gs^Fms, Gs, Gs, Gg, Gg, Gs^Fds, Gg, Gs^Fds, Gg, Gg, Gs, Gs, Gd, Gg, Gs, Gs, Gs, Gg, Gg, Gg, Gg, Gg, Gg, Gg, Gg, Gg, Gs, Gs, Hh, Hh, Mm, Mm, Mm, Mm, Mm, Mm, Mm^Xm, Mm^Xm, Mm^Xm
Gs^Fms, Gs^Fms, Gs^Fms, Gg^Fms, Gs^Fms, Gs^Fds, Gs^Fms, Gs^Fms, Gs^Fds, Gg^Em, Gg, Gg, Gg, Gg, Gg, Gg, Gg, Gs, Gg, Gg, Gg, Gg, Gs^Fms, Gs, Gs^Fms, Gg, Gg, Gs, Gs, Hh, Hh, Mm, Mm, Mm, Hh, Mm, Mm, Mm^Xm, Mm^Xm, Mm^Xm
Gs^Fds, Gs^Fms, Gs^Fms, Gs^Fms, Gs^Fms, Gs^Fds, Gs^Fms, Gs^Fms, Gs, Gs^Fds, Gs^Fds, Gg, Gg, Gg, Gs^Fds, Gg, Gg, Gg, Gg, Gg, Gg, Gg, Gs^Em, Gs^Fds, Gs^Fds, Gg, Gg, Gs, Gs, Gs, Hh, Hh, Hh, Hh, Mm, Mm, Mm, Mm^Xm, Mm, Mm
Gs^Fds, Gs^Fms, Gs^Fms, Gs^Fms, Gs^Fms, Gg^Em, Gs^Fms, Gs, Gs, Gs^Fds, Gs, Gs, Gg, Gs, Gs^Fds, Gs^Fms, Gs, Gg, Gs^Fms, Gg, Gg, Gs^Fds, Gs^Fds, Gs^Fms, Gg, Gg, Gg, Gg^Efm, Gs, Gs, Hh, Hh, Hh, Hh, Mm, Mm, Mm, Mm, Mm, Mm
Gs^Fds, Gs^Fds, Gg, Gg, Gg, Gs^Fds, Gs^Fds, Gs, Gg, Gg, Gg, Gg, Gg, Gs, Gs, Gs^Es, Gs, Gg, Gg, Gg, Gg, Gg, Gg, Gg, Gg, Gg, Gg, Gg, Gs, Gs, Gs, Hh, Hh^Es, Mm, Mm, Mm, Hh, Hh^Vhh, Mm, Mm
Gg, Gs^Fds, Gg, Gg, Gg, Gg, Gg, Gg, Gg, Gg, Hh, Gg, Hh, Gg, Gg, Gg, Gg, Gg, Gg, Gg, Gg, Gg, Gg, Gg, Gg, Gg, Gg^Es, Gg, Gg, Gs, Gs, Hh, Hh, Mm, Mm, Mm, Hh, Mm, Mm, Mm
Gg, Gg, Gg, Gg, Gg, Gg, Gg, Gg, Gs^Fds, Hh, Hh^Fds, Hh, Hh, Hh^Fds, Gs^Fms, Gg, Gg, Gg, Gs^Fds, Gs^Fms, Gs, Gg, Gg, Gg, Gg, Gs^Fds, Gs^Fds, Gs^Fds, Gg, Gs, Gs, Hh, Hh, Hh, Hh, Hh, Mm, Mm, Mm, Mm
Hh^Fds, Gg, Gg, Gg, Gg, Gg, Gg, Gs^Fds, Gs^Fms, Gs^Fms, Gs^Fds, Hh, Hh, Hh^Fds, Gg, Gg, Gg, Gg, Gs, Gs, Gs, Gg, Gg, Gg^Efm, Gg, Gg, Gg, Gg, Gg, Gs, Gs, Gs, Gs, Hh, Hh, Hh, Hh, Mm, Mm, Mm
Hh, Hh, Gs, Gg, Hh, Gg, Gg, Gs^Fds, Gs^Fms, Gs^Fms, Gs, Gs^Fds, Gs^Fds, Gg, Gg, Gg, Gg, Gs, Gs, Gs, Gs^Fds, Gs, Re^Fds, Gg, Gg, Gg, Gs^Fds, Gg, Gg, Gg, Gs, Gs, Gs, Hh, Hh, Hh, Hh, Hh, Mm, Mm
Hh, Hh, Hh, Hh, Hh^Fms, Hh^Fds, Gg, Gg^Em, Gs^Fms, Gs, Gs, Gs^Fds, Gs, Gs, Gg, Gg, Gg, Gs, Gs^Fds, Gs^Fds, Gs^Fms, Gs, Re^Fds, Gg^Es, Re^Fds, Gg, Gs^Fds, Gg, Gg, Gs, Gs, Gs, Gs, Gs, Gs, Hh, Hh, Hh, Hh, Mm
Hh, Hh, Hh, Hh, Hh^Fms, Hh, Gg, Gs^Fds, Gs^Fds, Gs, Gg, Gg, Gg, Gs, Gg, Gg, Gg, Gg, Gg, Gs^Fds, Gs^Fds, Gs^Fds, Gs^Fds, Re^Fds, Gg^Fms, Gg, Gg, Gg, Gg, Gg, Gs, Gs, Gs, Gs, Gs, Hh, Hh, Hh, Hh, Mm
Hh, Hh, Hh^Fms, Hh^Fds, Hh^Fds, Hh, Gg, Gg, Gg, Gg, Gg, Gg, Gg, Gg, Hh, Gg^Efm, Hh^Em, Hh, Gs, Gs^Fds, Gs^Em, Gs^Fds, Gs^Fds, Gs^Fms, Gs^Fms, Gg, Gg, Gg, Gg, Gg, Gg, Gs, Gs, Gs, Re, Re, Re, Hh, Hh^Emf, Hh
Hh, Hh, Hh, Hh^Vh, Hh, Hh, Hh, Gg, Gg, Gg, Gg, Gg, Gg, Hh, Hh, Hh, Hh, Hh^Fms, Gg, Gs, Gs^Fds, Gs^Fds, Gs^Fds, Gs^Fds, Gs^Fds, Gg^Fds, Gg^Fds, Gg, Gg, Ket, Re, Gg, Re, Re, Gs, Gs, Gs, Gg^Vh, Wwr, Wwr
Hh, Hh, Hh, Hh, Hh, Hh, Hh^Es, Gg, Gg, Gg, Gg, Gg, Hh, Hh, Hh^Es, Wwf^Es, Hh, Hh, Gg^Fds, Hh^Fms, Gs^Fms, Gs^Fds, Gs^Fds, Gs^Fds, Gs^Fms, Gg^Fds, Gg, Gg, Gg, Gg, Re, Re, Gg, Re, Re, Rb^Gvs, Rb^Gvs, Hh^Emf, Wwr, Hh
Hh, Hh, Hh, Hh, Gg^Fds, Hh^Es, Hh^Fms, Hh, Gg, Gg, Gg, Gg, Hh, Hh, Hh^Fds, Wwf^Es, Gg^Fms, Hh, Hh^Fds, Hh^Fms, Gs^Fds, Gs^Fds, Gg, Gs^Vc, Gs, Gg, Gg, Gg, Re, Re, Wwf, Wwf, Wwf, Rb^Gvs, Rb^Gvs, Rb^Vwm, Ww^Es, Ww^Es, Hh, Hh^Es
Hh, Hh, Hh^Fds, Gg^Fms, Gg^Fds, Gs^Fds, Hh^Fms, Hh^Fms, Gs, Gg, Gg, Gg^Efm, Hh, Hh^Fds, Hh^Es, Wwf^Es, Wwf^Es, Hh, Hh, Gs^Fds, Gg^Fds, Gg^Fms, Ce, Re, Re, Gg, Gg, Gg, Re, Rb^Gvs, Gg, Hh, Wwf, Rb^Gvs, Ww, Ww^Es, Hh, Hh, Hh, Hh
Hh, Hh, Gg^Fms, Gg^Fds, Gg^Fms, Gs^Fds, Hh^Fds, Hh^Fds, Hh^Fds, Gs, Gg, Gg, Gg, Hh, Hh, Hh, Gg^Fds, Ww^Es, Hh, Gg^Fds, Gg^Fds, Ke, Ce, Gg, Gs, Re, Re, Gg, Re, Gg, Gg, Rb^Gvs, Gll, Ww, Gg, Rb^Gvs, Hh, Hh, Hh, Hh
Hh, Hh, Hh^Fet, Gg^Fms, Gg^Fms, Gg^Fms, Gg^Fds, Gs, Gs, Gs, Gg, Gg, Gg, Gg, Gg^Efm, Hh, Hh^Emf, Ww^Es, Ww, Gg, Gg, Ce, Gg, Gg, Gg, Gs, Re, Re, Ce, Rb, Rb, Gg^Vh, Ww, Ww, Re, Re^Vh, Hh, Hh, Hh^Edt, Mm
Hh, Hh, Hh, Hh, Hh^Fds, Gg^Fms, Gg^Fds, Gg^Fms, Gs, Gs, Gg, Gg, Gg, Gg, Re, Gs^Vh, Hh, Hh, Rb^Gvs, Ww, Ww, Gg, Rb^Gvs, Gs^Vh, Re, Re, Ce, Ke, Ww, Ww, Ww, Ww^Bw\, Ww^Bw\, Rb, Gg, Hh, Gll^Fp, Hh, Mm, Mm
Hh, Hh, Hh^Fms, Hh, Hh, Hh^Fds, Hh, Gs, Gs, Gs, Gg, Gg, Ket, Gg, Re, Gg, Gg, Gg^Efm, Re^Vh, Rb^Gvs, Gg, Ww, Ww^Bw/, Rb, Re^Gvs, Rb, Ce, Ww, Ww, Ww, Ww, Ww, Rb, Rb, Hh, Hh^Fp, Gll^Fp, Mm, Mm, Mm
Hh, Hh^Fds, Hh, Hh, Hh, Hh, Hh, Gg^Fds, Hh, Gs, Gg, Gg, Gg, Re, Gg, Gg, Gg, Gg, Re, Gg, Re, Rb, Gg, Ww, Re^Es, Ww, Ww, Ww, Wot, Ww, Ww, Ww, Gg^Vh, Gg^Em, Hh^Fp, Hh^Fms, Hh, Mm, Mm, Mm
Hh, Hh, Gg^Efm, Gg^Efm, Hh^Fms, Hh, Hh^Fet, Hh, Hh^Fds, Gs, Gs, Gg, Gg^Eff, Re, Re, Gg, Gg, Gg, Re, Re, Gg, Re, Gg, Ww, Ww, Ww, Wot, Wot, Wo, Wot, Wot, Ww, Rb^Gvs, Hh, Hh^Fp, Hh^Fp, Mm, Mm, Mm, Mm
Hh, Hh, Hh^Fms, Gg^Efm, Hh, Hh, Hh, Hh, Gs, Gs^Efm, Gg^Eff, Gs^Eff, Rd^Gvs, Gg^Eff, Rb^Eff, Re, Rb^Gvs, Re, Gg, Gg, Re^Vh, Re, Rb, Ww, Ww, Ww, Wot, Wo, Wo, Wot, Wot, Ww, Wwr, Hh^Fp, Hh^Fp, Mm, Mm, Mm, Mm, Mm
Hh, Hh, Hh, Gg, Gg, Gg^Efm, Hh, Hh, Gs^Eff, Gg^Eff, Rd^Gvs, Re^Gvs, Re, Re^Eff, Gg, Ww, Ww, Rb, Ww, Rb^Gvs, Rb^Gvs, Gg, Ww, Ww^Bw\, Rb, Ww, Ww, Wot, Wot, Wo, Ww, Ww, Wwr, Hh^Fp, Hh^Fms, Hh, Mm, Mm, Mm, Mm
Hh, Hh, Hh, Gg, Gg, Gg, Gg, Gs, Gg, Gg^Eff, Gg^Eff, Gg^Eff, Re^Vh, Gs, Gg, Rb^Gvs, Rb^Gvs, Ww^Bw|, Gg, Ww, Ww, Ww, Ww, Ww, Re^Gvs, Gg^Vc, Gs^Fds, Ww, Ww, Ww, Ww, Ww, Ww, Hh^Fp, Hh^Fp, Hh^Fms, Mm, Mm, Mm, Mm
Hh, Hh^Fds, Hh^Fms, Hh, Hh^Fds, Gg^Es, Gg, Gg, Gg, Gg, Gg, Gg, Gg, Gg, Gg, Gs, Re, Rb, Gg^Fds, Gg^Fds, Wwr, Ww, Ww, Ww, Ww, Gs^Fds, Ww, Gs^Fds, Ww, Ww, Ww, Ww, Ww, Ww^Es, Hh, Hh^Fp, Mm, Mm, Mm, Mm
Hh, Hh, Hh, Hh, Hh, Gg^Es, Gg, Gg, Gg, Gg, Gg, Gg, Gg, Gg, Gg, Re, Re, Gg, Gg^Fds, Gg^Fds, Wwr, Ww, Ww, Ww, Ww, Ww, Ww, Ww, Ww, Ww, Ww, Ww, Ww, Ww, Hh, Mm, Mm, Mm, Mm, Mm
