Rrc, Mm, Rrc, Mm, Rrc, Co, Co, Wwg, Mm, Wwg, Wwg, Wwg, Co, Wwg, Hhd^Fp, Ha^Fp, Mm, Mm, Mm, Ha, Hhd, Hhd, Hhd, Hhd, Ha, Gd, Gd, Gd, Gd, Gd, Gd, Gd, Gd, Rrc, Gd, Aa, Aa, Aa^Fp, Hhd, Ha, Chr, Mm, Mm^Xm, Mm, Ms^Xm, Ms^Xm, Ms^Xm, Ms^Xm, Ms^Xm, Ms^Xm, Ms, Ms, Ms, Mm, Ms^Xm, Mm^Xm, Ms^Xm, Mm
Rrc, Rrc, Rp^Em, Aa, Aa^Esa, Rrc^Vo, Rrc, Gd^Es, Rp, Coa, Co, Gd, Gd, Wwg, Wwg, Hhd^Fp, Hhd, Coa, Mm, Ha^Voa, Ha^Esa, Hhd, Hhd, Ha, Gd, Gd, Gd, Aa^Fp, Aa^Fp, Gd, Aa^Esa, Gd, Gd, Rrc, Rrc, Gd, Gd, Aa^Fp, Gd, Hhd, Hhd, Hhd^Fp, Hhd, Ha^Voa, Mm, Ms, Ms, Ms^Xm, Ms^Xm, Ms^Xm, Ha^Fp, Ms, Ms^Xm, Ms^Xm, Ms^Xm, Ms^Xm, Ms, Ms
Ss, Gd, Gd, Rb, Rb, Rrc, Rp^Ecf, Rrc, Rrc, Rrc, Rrc, Rb, Gd, Co, Coa, Wwg, Hhd, Hhd, Ms, Ms, Ms, Hhd, Hhd, Gd, Gd, Gd, Gd, Aa, Aa, Aa, Aa^Fms, Aa^Fp, Gd, Gd, Aa^Esa, Aa, Gd, Gd, Gd, Gd, Gd, Rb, Ha, Ha, Hhd, Mm, Ha, Ms^Xm, Ms, Hhd^Fp, Ms, Hhd, Ms, Ms, Ms, Ms, Ms, Ms
Sm, Sm, Ss, Gd, Coa, Co, Rp, Rd, Rrc, Rrc, Rrc, Rb, Rb, Co^Vo, Re, Wwg, Wwg, Hhd, Hhd^Fp, Ms, Mm, Hhd, Hhd, Hhd, Gd, Aa, Aa, Aa, Gd, Gd, Aa, Aa^Fp, Cer, Gd, Rp, Aa, Aa, Gd, Aa^Esa, Gd, Gd, Rb, Rb, Ha, Rb, Hhd, Hhd, Hhd^Fp, Mm, Ha^Esa, Hhd, Ms^Xm, Ha^Fp, Ms, Ms, Ha^Esa, Ms^Xm, Ms^Xm
Ss, Ss, Sm, Sm, Sm, Co, Co, Ko, Rp, Rp, Aa^Esa, Rrc, Rrc, Gs, Aa, Co, Wwg, Wwg, Ha, Mm, Ms, Hhd^Voa, Hhd, Hhd, Hhd, Aa^Fp, Aa, Aa^Esa, Gd, Gd, Gd, Gd, Aa, Rp, Ker, Gd, Gd, Aa, Aa, Aa, Gd, Gd, Gd, Rb, Rb, Rb, Hhd, Ms^Xm, Mm, Hhd, Ha, Ms^Xm, Ha, Ms, Ha^Voa, Ms, Ms^Xm, Ms^Xm
Ss^Vo, Ss, Gs, Co^Vo, Co, Co, Ko, Coa, Co, Co^Vo, Aa, Gd, Rrc^Ecf, Rrc, Gs, Wwg, Coa, Wwf, Sm, Ha, Ms, Ms, Ms, Hhd^Voa, Hhd, Aa, Aa^Fms, Aa^Fp, Gd, Gd, Rb^Voa, Aa, Aa, Cer, Cer, Gd, Aa, Gd, Aa, Aa^Fp, Gd, Gd, Gd, Gd, Rb, Rb, Ha, Ha, Hhd, Ha, Chr, Mm, Ms, Hhd, Ms, Ha, Ms, Ms
Sm, Sm, Rp^Em, Co, Rp, Co, Co^Vo, Co, Rp, Co, Rp^Es, Gd, Gll^Fdw, Rrc, Gs^Es, Re, Gd, Co, Sm, Hhd, Coa, Mm, Ms, Ms, Hhd, Ha, Ha^Fp, Aa^Fms, Gd, Gd, Gd, Gd, Aa, Gd, Gd, Gd, Aa^Es, Aa, Gd, Gd, Gd, Gd, Gd, Gd, Rb, Hhd, Mm, Hhd, Hhd, Hhd^Fp, Mm^Xm, Mm, Ms, Ms, Ms, Ms, Ms^Xm, Ms
Rrc, Rp, Rd, Rrc^Ecf, Rrc, Ko, Gs^Es, Co, Coa, Rp, Rrc, Gs, Rrc, Rrc, Rrc, Gs, Gd, Co, Wwg, Hhd, Hhd, Mm, Ha, Hhd, Co, Hhd, Gd, Gd, Gd, Gd, Gd, Gd, Rrc, Gd, Gd, Gd, Gd, Aa, Gd, Gd, Gd, Gd, Rb, Rb, Hhd, Hhd^Fp, Ms^Xm, Ms, Ha, Ms, Ms, Ms, Mm^Xm, Ms, Ms, Ms^Xm, Ms, Ms
Gs, Rb, Aa, Rd, Rrc, Rp, Gs, Co, Gs, Gs, Gs^Vo, Rrc, Rrc, Rb, Rb, Rrc, Rrc^Vo, Rrc, Rrc, Sm, Rb^Em, Ha, Rrc, Hhd, Rp, Gd^Es, Rrc, Rp, Rp, Rp, Rp, Rrc, Gd, Gd, Gd, Gd, Aa, Gd, Gd, Gd, Gd, Rb, Rb, Hhd, Ha, Ms, Ms^Xm, Ms, Ha, Ms, Ha, Hhd^Fp, Ms^Xm, Ms, Ms, Ms, Ms, Ms
Gs, Gs^Es, Gll^Fdw, Aa^Esa, Rrc, Rrc, Rrc, Rp, Rrc, Rrc, Rrc, Rrc, Aa, Aa, Rb, Rrc, Rp, Rp, Rp, Rrc, Rp, Rrc, Hhd, Rp, Co, Rrc, Gd, Aa, Gd, Gd, Gd, Aa, Aa, Gd, Gd, Aa, Gd, Gd, Gd, Gd, Rb, Rb, Ha, Ha, Ms, Mm, Mm, Mm, Hhd, Mm, Ha, Ms, Ms, Ms, Ms^Xm, Ms, Ms, Ms^Xm
Wwf, Wwg, Gd^Vo, Rrc, Aa, Rb, Rrc, Rrc, Rp^Ecf, Rd, Rrc, Rb, Aa, Aa, Aa, Rb, Ss, Wwg, Ss, Sm, Co, Hhd, Ms, Hhd, Hhd, Ha, Gd, Gd, Gd, Gd, Gd, Gd, Aa, Aa^Esa, Aa, Gd, Gd, Gd, Aa, Rb, Aa, Aa, Ha, Ha^Fp, Mm^Xm, Ms^Xm, Hhd, Mm, Hhd, Ha, Ha^Esa, Ms, Ms, Ms, Ms, Ms, Ms, Ms
Ss, Sm, Gd, Gd^Es, Gs, Rb, Rrc, Rd, Gs, Rd, Gs, Rrc, Gd^Vo, Aa^Esa, Rd, Gs, Coa, Ss, Hhd, Hhd, Mm, Mm, Hhd, Hhd^Voa, Hhd, Ha^Es, Gd, Gd, Aa, Gd, Aa^Fp, Gd, Gd^Es, Rb, Gd, Gd, Gd, Gd, Gd, Rb, Aa, Hhd, Ha, Mm, Mm, Chr, Hhd, Hhd, Mm, Ha^Fp, Mm, Ms, Mm^Xm, Ms, Mm^Xm, Ms, Mm^Xm, Ms
Ss, Co, Wwg, Gd, Wwf, Gs, Rp, Rp, Re, Gs, Gd, Rrc, Rd, Re, Wwg, Co, Wwg, Hhd, Hhd, Hhd^Fp, Ms, Mm, Hhd, Hhd, Ha, Gd, Gd, Gd, Aa, Aa, Aa, Gd, Gd, Rb, Gd, Gd, Gd, Gd, Aa, Rb, Hhd, Hhd, Hhd, Hhd, Hhd, Hhd, Hhd, Mm, Mm, Mm, Mm^Xm, Mm^Xm, Xu, Ms^Xm, Xu, Ms^Xm, Ms^Xm, Ms^Xm
Ss, Sm, Sm, Wwg, Co, Co, Coa, Re, Wwg, Re, Co, Rp, Co, Wwg, Ss, Ss, Hhd, Hhd, Ms, Ms, Ha, Ha, Hhd, Ha, Gd, Gd, Aa^Voa, Aa^Esa, Aa, Gd, Gd, Gd, Gd, Rb, Gd, Gd, Gd, Aa, Aa^Fp, Aa, Hhd, Hhd, Hhd, Hhd, Hhd, Hhd, Mm, Mm, Mm, Mm, Mm, Xu, Uh, Xu, Uh, Mm^Xm, Xu, Ms^Xm
Ss, Sm, Sm, Ss, Sm, Sm, Ss, Ss, Sm, Co, Ss, Rb, Sm, Sm, Ss, Hhd, Hhd^Fp, Ms, Ms, Ms, Hhd, Hhd, Gd, Gd, Gd, Aa, Aa^Fp, Aa, Gd, Gd, Gd, Gd, Gd, Rb, Rb, Gd, Gd, Gd, Aa^Fp, Ha, Ha^Fp, Ha^Voa, Ms^Xm, Hhd, Hhd, Ha, Mm, Mm, Ms^Xm, Ms^Xm, Xu, Uh^Vu, Cte, Cte, Cte, Uh, Xu, Xu
Ha, Ss, Hhd, Ss, Hhd, Hhd, Hhd, Hhd, Hhd, Ss, Hhd, Ss, Ha, Ha, Coa^Voa, Mm, Mm, Mm, Hhd, Hhd, Ha, Ha, Gd, Gd, Gd, Gg^Fp, Gg^Fp, Gd, Gd, Gd, Gd, Gd, Gd, Gd, Gd, Rb, Gd, Gg^Fms, Gg^Fp, Ha, Ha, Mm, Mm, Mm, Ha^Fp, Ha, Mm, Mm, Ms^Xm, Xu, Xu, Sm, Sm, Kte, Uu, Uu^Vu, Uu, Uu
Hh, Hhd^Fms, Hh^Voa, Hhd^Fp, Ms, Ms, Ms, Hhd, Ha, Hhd, Co, Hhd, Hhd^Fms, Ms, Ha, Mm, Hhd, Hhd, Hhd, Hhd, Gd, Gd, Gd, Gd, Gd, Gd, Gd, Gd, Gd, Gd, Gd, Aa^Esa, Aa, Aa, Gd, Rb, Aa^Esa, Gd, Aa^Fms, Hhd, Ha, Mm, Ms, Ms, Mm, Ha, Chr, Mm, Hhd, Ha, Uh, Uu, Uu, Cte, Uu, Uu, Uh, Uu
Ms, Ms, Ms, Ha^Fp, Ms, Ms, Hhd, Mm, Mm, Mm, Ha, Mm, Ms, Ms, Ha^Esa, Hhd, Rb, Hhd, Gd, Gd, Gd, Gd, Gd, Gd, Gd, Gd, Gd, Gd, Gd, Gd, Gd, Aa^Voa, Aa, Gd, Rb, Rb, Aa^Esa, Aa, Gd, Gd, Hhd, Hhd, Ms, Ms, Mm^Xm, Ha, Hhd, Hhd, Hhd, Hhd, Ms, Uh, Sm, Sm, Uh, Uu, Uh, Xu
Hhd, Ms, Ha, Mm, Hhd, Hhd, Hhd, Hhd^Vo, Ha, Mm, Hhd, Hhd, Hhd, Ha, Hhd, Hhd, Rb, Rb, Gd, Gd, Gd, Ha^Fp, Hh, Hh, Gd, Gd, Gd, Gd, Gd, Gd, Gd, Gd, Rb, Rb, Gd, Aa, Aa, Gd, Gd, Gd, Hhd, Hhd, Hhd, Mm, Ms, Hhd, Hhd, Hhd, Mm, Ms, Xu, Uh^Vu, Uh, Uu, Uh, Uh, Xu, Xu
Hhd, Hhd, Hhd, Ha^Esa, Gd, Hhd, Ha, Ha, Ha, Ha, Rb, Ha, Ha, Hhd, Aa, Rb, Gd, Gd, Gd, Gd, Gd, Ha^Esa, Ha, Hh, Gd, Gd, Gd, Gd, Gd, Gd, Rb, Rb, Gd^Es, Gd, Gd, Gd, Gd, Gd, Aa^Fp, Gd, Hhd, Hhd, Ha, Chr, Ms, Hhd, Hhd, Hh^Fp, Mm, Ms^Xm, Ms^Xm, Xu, Ms, Xu, Xu, Xu, Xu, Xu
Hhd, Hhd, Gd, Gd, Gd, Gd, Gd, Rb, Rb, Rb, Rb, Re, Gd, Aa, Cer, Rb, Gd, Gd, Hh, Gd, Gd, Hh, Hh, Hh, Gd, Gd, Aa, Aa^Esa, Rb, Rb, Gd, Gd, Gd, Gd, Gd, Gd, Re, Rb, Aa, Aa, Gd, Hhd, Ha^Fp, Ha, Hhd, Hhd, Ha, Ha^Voa, Ms, Ms, Ms^Xm, Ms, Ms^Xm, Ms^Xm, Ms^Xm, Xu, Ms^Xm, Ms^Xm
Ha, Hhd, Gd, Gd, Hhd, Gd, Hhd, Gd, Cer, Rb, Gd, Gd, Gd, Aa, Gd, Gd, Ha, Hh, Ha^Fp, Ha, Gd, Gd, Gd, Gd, Gd, Aa^Es, Aa, Aa, Rb, Gd, Gd, Gd, Gd, Gd, Gd, Aa, Aa^Fp, Rb, Aa, Aa^Esa, Aa, Gd, Ha, Hhd, Hhd, Hhd, Ha, Ms^Xm, Ms, Ms, Mm, Mm, Mm, Ms^Xm, Ms^Xm, Ms^Xm, Ms^Xm, Ms^Xm
Ha, Gd, Gd, Gd, Mm, Gd, Hhd, Hhd, Aa, Ker, Aa, Gd, Gd, Gd, Gd, Gd, Ha^Esa, Hh, Ha, Ha, Gd, Gd, Gd, Aa, Aa^Fp, Aa^Fms, Aa^Voa, Aa^Esa, Aa, Gd, Gd, Gd, Gd, Gd, Gd, Gd, Gd, Rb, Aa, Aa, Gd, Gd, Gd, Ha, Gd, Hhd, Hhd, Ha^Fp, Mm, Mm, Mm, Mm, Mm, Mm, Mm, Ms^Xm, Ms^Xm, Ms^Xm
Ha, Gd, Gd, Hhd, Ha, Ms, Ms, Ha, Ha, Aa, Gd, Gd, Aa, Aa, Gd, Ha^Fp, Ha, Hh, Aa, Ha^Esa, Gd, Gd, Gd, Gd, Aa, Aa^Fp, Aa, Aa, Aa, Aa, Rb, Gd^Es, Rb, Gd, Gd, Gd, Gd, Gd, Gd, Gd, Gd, Gd, Gd^Efm, Gd, Gd, Hhd, Hhd, Hhd, Hhd, Ms, Ms, Mm, Ms, Mm, Ms, Mm, Ms, Ms^Xm
Hhd, Hhd, Gd, Ha, Ha, Mm, Hhd, Hhd, Aa, Gd, Gd, Gd, Aa, Cer, Gd, Gd, Gd, Aa, Gd, Gd, Gd, Gd, Gd, Gd, Gd, Gd, Gd, Gd, Gd, Gd^Es, Gd, Rb, Gd, Rb, Rb, Rb, Rb, Gd, Gd, Gd, Gd, Gd, Gd, Gd, Gd, Gd, Gd, Hhd, Gd, Hhd, Ha, Ms, Chr, Mm, Mm, Mm, Mm, Ms
Hh^Fms, Hhd, Gd, Gd, Gd, Hhd, Ha, Ha, Aa, Gd, Aa^Voa, Aa, Aa, Gd, Gd, Aa, Gd, Gd, Gd, Gd, Gd, Gd, Gd, Gd, Gd, Gd, Gd, Gd, Rb, Gd, Gd, Gd, Gd, Gd, Gd, Gd^Es, Gd, Rb, Gd, Gd, Gd, Gd, Aa, Gd, Gd, Gd, Gd, Gd, Gd, Hhd, Hhd, Ha, Ha, Ms^Xm, Ms, Mm, Ms, Ms
Aa^Fp, Aa^Fp, Gg^Fms, Gd, Gd, Gd, Gd, Aa, Gd, Gd, Aa, Aa, Gd, Gd, Gd, Gd, Gd, Gd, Aa, Gd, Aa, Ha, Ha^Fp, Aa, Aa^Esa, Aa, Aa, Rb, Rb, Re, Re, Gd, Gg^Fms, Gd, Gd, Gd, Gd, Aa, Aa^Esa, Gd, Aa, Aa, Aa^Fp, Aa, Aa, Gd, Gd, Gd, Gd, Gd, Ha, Ha^Esa, Hhd, Ha^Fp, Ms, Ms, Ms, Mm
Aa^Fp, Aa^Fp, Aa^Fma, Gd, Gd, Gd, Gd, Gd, Gd, Gd, Gd, Gd, Gd, Gd, Gd, Gd, Gd, Gd, Aa, Aa^Esa, Ha, Ha, Aa, Aa, Gd, Aa^Voa, Rb, Rb, Rb, Re, Gd, Gd, Gg^Fms, Aa^Fp, Aa, Gd, Gd, Rb, Aa, Aa^Vwm, Aa, Aa^Fp, Aa, Aa, Aa, Aa^Esa, Gd, Gd, Gd, Gd, Gd, Ha, Ha, Hhd, Hhd^Voa, Ms, Ms, Mm
Ha, Ha^Esa, Hhd, Gd, Gd^Efm, Gd, Gd, Gd, Gd, Gd, Gd, Gd, Gd, Gd, Gd, Gd, Gd, Gd, Aa, Ha^Fp, Ha^Esa, Ha^Esa, Hh, Gd, Gd, Aa, Rb, Rb, Gd, Gd, Gd, Gd, Gd, Aa, Aa^Esa, Aa, Rb, Rb, Aa^Fp, Re, Gd, Aa, Aa, Aa^Voa, Aa, Aa, Aa^Fms, Gd, Gd, Gd, Gd, Gd, Ha, Hhd, Mm, Mm, Ms, Ms
Ms, Ms, Ms, Ha, Ms, Hhd, Ha, Hhd, Gd^Efm, Gd, Gd, Gd, Gs^Fms, Gd^Efm, Gs^Fms, Gd, Gd, Gd, Aa, Ha, Ha, Hh, Gd, Gd, Gd, Gd, Gd, Gd, Gd, Gd, Rb, Rb^Es, Rb^Es, Gd, Aa, Aa^Fp, Gd, Rb, Re, Re, Gd, Aa, Aa, Aa, Gd^Esa, Aa, Aa^Fp, Gd, Gd, Gd, Gd, Gd, Hhd, Mm, Ms, Mm, Ha^Fp, Mm
Ms, Ms, Ms, Ms, Ms, Ms, Ms, Ha^Esa, Hh^Fms, Gd^Fms, Aa^Fms, Gll^Fp, Aa^Fms, Gll^Fp, Aa^Fp, Gll^Fp, Gs^Fms, Gd, Gd, Gd, Gd, Gd, Gd, Gd, Aa, Aa, Rb, Gd, Rb, Rb, Gd, Gd, Gd, Rb, Aa, Aa, Gd, Rb, Gd, Gd, Rb, Rb, Re, Re, Aa, Aa, Gd, Gd, Gd, Gd, Gd, Gd, Gd, Hhd, Ha, Ha^Esa, Ha, Ha
Ms, Ms, Ms, Ms, Ms, Ms, Ms, Ha, Hhd^Fp, Ha^Fms, Aa^Fma, Gll^Fp, Gll^Fp, Aa^Fp, Gs^Fms, Gs^Fms, Aa^Fms, Aa^Fp, Aa^Fms, Gd, Gd, Gd, Rb, Gd, Aa, Rb, Gd, Rb, Re^Edt, Gd, Gd, Gd, Gd, Aa^Fp, Gd, Aa^Esa, Aa, Aa^Voa, Gd, Re, Aa^Fp, Rb, Re, Re, Re, Re, Re, Gd, Ce, Gd, Gd, Gd, Gd, Gd, Hhd, Ha, Gd, Ha
Ms, Ms, Hhd^Fms, Ha, Ha^Fms, Ms, Ha^Fms, Ha^Fp, Hhd^Fp, Hhd^Fms, Aa^Fp, Aa^Fma, Aa^Fms, Gll^Fp, Gs^Fms, Aa^Fp, Aa^Fms, Aa^Fp, Gs^Fms, Gll^Fp, Gd, Rb, Gd, Aa, Aa^Esa, Aa, Gd, Gd, Re^Edt, Re^Edt, Gd, Gd, Gd, Gd, Gd, Gd, Gd, Gd, Gd, Aa, Aa, Aa, Aa, Aa, Gd, Gd, Ce, Ce, Gd, Gd^Efm, Gd, Gd, Gd, Gd, Gd, Gd, Gd, Hh
Ha^Fms, Ha^Fp, Ha^Fms, Hhd^Fp, Hhd^Fms, Hhd^Fp, Hhd^Fms, Hhd^Fp, Hhd^Fms, Hhd^Fms, Aa^Fp, Gll^Fma, Gs, Gs^Fms, Gll^Fp, Aa^Fp, Gs^Fms, Gll^Fp, Gs^Fms, Gs^Fms, Gd, Rb, Gd, Aa^Fp, Aa, Aa^Voa, Gd, Re^Edt, Gd, Gd, Gd, Gd, Gd, Gd, Gs^Fms, Gs^Fms, Gd, Gd, Gd, Gd, Re, Re, Gd, Gd, Gd, Gd, Ce, 2 Ke, Aa, Gd, Gd, Gd, Gd, Gd^Efm, Gd, Gd, Gd, Gd
Hhd^Fms, Ha^Fp, Hhd^Fp, Hhd^Fms, Hhd^Fp, Hhd^Fp, Hhd^Fms, Ha^Fp, Hhd^Fp, Gll^Fp, Gll^Fp, Gll^Fp, Gd, Gs, Gd^Efm, Gll^Fp, Gs^Fms, Gs^Fms, Gll^Fp, Gd, Gd, Rb, Gd, Gd, Gd, Gd, Gd, Gd, Gd, Gd, Gll^Fp, Gs^Fms, Gll^Fp, Gs^Fms, Gll^Fp, Gll^Fp, Gll^Fp, Gd, Gs^Fms, Gd, Gd, Re, Gd, Gd, Gd, Gd, Gd, Gd, Gs^Fms, Gd, Gd, Gd, Gd, Gd, Gd, Gd, Gs^Fms, Gd
Hhd^Fp, Hhd^Fp, Ha^Fp, Ha^Fp, Ha^Fms, Ha^Fma, Aa^Fma, Gll^Fp, Gll^Fp, Gs, Gs, Gd, Rb, Gs, Aa, Gd, Gd, Gd, Gd, Gd, Rb, Rb, Gd, Gd, Aa^Fp, Gd, Gs^Fms, Gd, Gs^Fms, Gll^Fp, Aa, Gll^Fp, Aa, Gd, Gll^Fp, Aa, Aa, Gll^Fp, Gs^Fms, Gd, Aa, Gd, Gd, Gd, Gd, Gd, Gs^Fms, Gs^Fms, Aa^Fms, Gd, Gll^Fp, Gs^Fms, Aa^Fp, Gs^Fms, Aa^Fp, Gs^Fms, Gs^Fms, Gs^Fms
Ha^Fp, Hhd^Fms, Hhd^Fp, Ha^Fms, Gg^Fp, Gs^Fms, Gd^Efm, Gs, Rb, Gs, Rb, Rb, Gd, Rb, Aa, Gd, Rb, Gd, Gd, Gd, Rb, Gd, Gd, Gs^Fms, Gll^Fp, Aa^Fp, Gll^Fp, Aa^Fms, Aa^Fp, Aa^Fp, Aa^Fms, Aa^Fp, Aa, Aa^Fp, Gll^Fp, Gd, Aa^Fp, Aa^Fp, Aa^Fp, Gd, Aa, Ce, 1 Ke, Ce, Gd, Gd, Gs^Fms, Gs^Fms, Gll^Fp, Gs^Fms, Gll^Fp, Aa^Fp, Gll^Fp, Aa^Fms, Aa^Fp, Gs^Fms, Gs^Fma, Gll^Fp
Ha^Fp, Hhd^Fp, Gs, Gd^Es, Gd, Gd, Rb, Rb, Gs^Fms, Rb, Gs^Fms, Gd, Aa^Fms, Aa^Fp, Gs^Fms, Rb, Aa, Rb, Aa^Esa, Rb, Gd, Gd, Gll^Fp, Gs^Fms, Gd, Gd, Gs^Fms, Aa^Fp, Aa^Fp, Gs^Fms, Gll^Fp, Gd, Gll^Fp, Aa, Gll^Fp, Gll^Fp, Gg^Fp, Gll^Fp, Gll^Fp, Gs^Fms, Gll^Fp, Gd, Ce, Ce, Gd, Gd, Gll^Fp, Aa^Fms, Aa^Fp, Aa, Gs, Gs^Fms, Gll^Fp, Aa^Fp, Aa^Fp, Aa^Fp, Aa^Fma, Gs^Fms
Gs, Gs, Aa, Gd, Rb, Rb, Sm, Aa^Fms, Sm, Gs^Fms, Aa^Fp, Aa^Fp, Aa^Fma, Aa^Fp, Gll^Fp, Aa^Fms, Aa, Aa, Aa, Gd, Gd^Efm, Gll^Fms, Aa^Fp, Gs^Fms, Aa^Esa, Gs^Fms, Gs^Fms, Gs^Fms, Aa, Gd, Gs^Fms, Aa, Aa, Aa^Fp, Aa^Fp, Gll^Fp, Gll^Fp, Gll^Fp, Gs^Fms, Gd, Aa^Fp, Gd, Gd, Gd^Efm, Gd, Gg^Fp, Aa^Fma, Aa^Fms, Aa^Fp, Aa^Vea, Aa^Fp, Aa^Fp, Gs^Fms, Gs, Aa, Aa^Fp, Gll^Fp, Gll^Fp
Rb, Rb, Aa^Fp, Aa, Aa^Fp, Sm, Gs^Fms, Aa^Fp, Sm, Ss, Sm, Gs^Fms, Gs^Fms, Aa^Fma, Aa, Gs^Fms, Aa^Fms, Aa^Vea, Aa^Fma, Aa, Aa^Fma, Aa^Fma, Gll^Fms, Gll^Fp, Aa^Fp, Gs^Fms, Aa, Gll^Fp, Aa, Aa, Gs^Fms, Gll^Fp, Aa^Esa, Aa^Fp, Gs^Fms, Gll^Fp, Aa^Fma, Gll^Fp, Aa^Fp, Gs^Fms, Gg^Fp, Aa, Gd, Gd, Gd, Gd, Gd, Gll^Fp, Gll^Fp, Aa^Fp, Gll^Fp, Gs^Fms, Gll^Fp, Gs, Gll^Fp, Gll^Fp, Gg^Fp, Gll^Fp
Aa, Aa, Aa, Aa^Fp, Ss, Aa^Fms, Gs^Fms, Ss, Aa^Fms, Ss, Gll^Fp, Aa^Fp, Gll^Fp, Gd, Aa^Fma, Gll^Fp, Gs^Fms, Aa^Fp, Aa^Fma, Aa^Fma, Gll^Fp, Aa^Fma, Gs^Fms, Gll^Fp, Aa^Fp, Aa^Fp, Aa^Fp, Gll^Fp, Gs^Fms, Gs^Fms, Gs^Fms, Aa^Fp, Gs^Fms, Gs^Fms, Aa^Fp, Gs^Fms, Gs, Aa^Fma, Gs^Fms, Gll^Fp, Gs^Fms, Aa, Gd, Gd, Gd, Gd, Gs^Fms, Gs^Fms, Aa^Fp, Gs^Fms, Aa^Fp, Gs^Fms, Aa^Fp, Gll^Fp, Gll^Fp, Aa^Fms, Aa^Fms, Gll^Fp
Aa^Fms, Gll^Fma, Aa^Fp, Ss, Sm, Sm, Aa, Gs^Fms, Sm, Gll, Ss, Ss, Gll^Fp, Aa^Fma, Gs^Fms, Aa^Fma, Gll^Fp, Gll^Fma, Gll^Fp, Aa^Fma, Gs^Fp, Gll^Fp, Gll^Fp, Aa^Fms, Aa, Aa^Fms, Aa^Fp, Gs^Fms, Gs^Fms, Gs^Fms, Aa^Fp, Aa^Fp, Aa^Fp, Gll^Fp, Aa, Aa, Gs, Gs^Fms, Gs^Fms, Gs^Fms, Aa, Gd, Gd, Gd, Gd, Aa^Fms, Aa^Fms, Aa, Gs, Aa, Gll^Fp, Gs^Fms, Aa^Fp, Aa^Fp, Aa^Fp, Aa^Fms, Aa^Fp, Gll^Fp
Aa^Fma, Aa^Fma, Aa^Fma, Aa^Fma, Aa^Fp, Aa^Fp, Gs^Fms, Ss, Aa^Fp, Gs^Fms, Aa, Aa^Fp, Gs^Fms, Gll^Fp, Aa, Gll^Fp, Aa^Fp, Gll^Fp, Gs^Fms, Gg^Es, Gs^Fms, Gs^Fp, Gs^Fms, Aa^Fms, Gs^Fp, Gs^Fms, Gg^Fms, Aa, Gg^Fp, Aa^Fp, Gs^Fms, Gs^Fms, Gll^Fp, Gs^Fms, Aa^Fp, Gg^Fms, Gs, Aa^Esa, Gs^Fms, Gs^Fms, Aa, Gd, Gll^Fp, Gd, Gd, Gd, Gs^Fms, Gs, Gs^Fms, Gll^Fp, Gs^Fms, Aa^Fms, Aa^Fp, Aa^Fp, Aa^Fp, Aa^Fp, Gll^Fp, Aa^Fms
Aa^Fp, Gs^Fms, Aa^Fms, Gll^Fp, Aa^Fms, Gs^Fms, Gll^Fp, Gll^Fp, Gll^Fp, Gs^Fms, Aa, Gll^Fp, Aa^Fp, Aa, Aa^Fms, Gll^Fp, Aa^Fms, Gll^Fp, Aa^Fp, Gg, Gg, Gs^Fms, Gs^Fms, Aa^Fp, Gg, Gs^Fms, Gs^Fms, Gg^Fp, Gg, Gg^Fp, Gg^Fp, Gll^Fp, Gg, Gll^Fp, Gs, Gs, Aa, Aa, Gs^Fms, Gg^Fms, Gll^Fp, Gs^Fms, Gd, Gd, Gd, Gd, Gs^Fms, Gll^Fp, Gll^Fp, Gs^Fms, Gll^Fp, Aa, Gll^Fp, Aa^Fp, Gll^Fp, Aa^Fp, Gll^Fp, Aa^Fp
