Isa, Md, Isa, Md, Isa, Co, Co, Wwg, Md, Wwg, Wwg, Wwg, Co, Wwg, Hhd^Fp, Ha^Fp, Md, Md, Md, Ha, Hhd, Hhd, Hhd, Hhd, Ha, Gd, Gd, Gd, Gd, Gd, Gd, Gd, Gd, Rrc, Gd, Aa, Aa, Aa^Fpa, Hhd, Ha, Chr, Md, Md^Xm, Md, Ms^Xm, Ms^Xm, Ms^Xm, Ms^Xm, Ms^Xm, Ms^Xm, Ms, Ms, Ms, Md, Ms^Xm, Md^Xm, Ms^Xm, Md
Isa, Isa, Rp^Em, Aa, Aa^Esa, Aa^Voa, Isa, Gd^Es, Rp, Coa, Co, Gd, Gd, Wwg, Wwg, Hhd^Fp, Hhd, Coa, Md, Ha^Voa, Ha^Esa, Hhd, Hhd, Ha, Gd, Gd, Gd, Aa^Fpa, Aa^Fpa, Gd, Aa^Esa, Gd, Gd, Rrc, Rrc, Gd, Gd, Aa^Fpa, Gd, Hhd, Hhd, Hhd^Fp, Hhd, Ha^Voa, Md, Ms, Ms, Ms^Xm, Ms^Xm, Ms^Xm, Ha^Fpa, Ms, Ms^Xm, Ms^Xm, Ms^Xm, Ms^Xm, Ms, Ms
Ss, Gd, Gd, Rb, Rb, Isa, Rp^Ecf, Isa, Isa, Isa, Isa, Rb, Gd, Co, Coa, Wwg, Hhd, Hhd, Ms, Ms, Ms, Hhd, Hhd, Gd, Gd, Gd, Gd, Aa, Aa, Aa, Aa^Fpa, Aa^Fpa, Gd, Gd, Aa^Esa, Aa, Gd, Gd, Gd, Gd, Gd, Rb, Ha, Ha, Hhd, Md, Ha, Ms^Xm, Ms, Hhd^Fp, Ms, Hhd, Ms, Ms, Ms, Ms, Ms, Ms
Sm, Sm, Ss, Gd, Coa, Coa, Rp, Rd, Isa, Isa, Isa, Rb, Rb, Co^Vo, Re, Wwg, Wwg, Hhd, Hhd^Fp, Ms, Md, Hhd, Hhd, Hhd, Gd, Aa, Aa, Aa, Gd, Gd, Aa, Aa^Fpa, Cer, Gd, Rp, Aa, Aa, Gd, Aa^Esa, Gd, Gd, Rb, Rb, Ha, Rb, Hhd, Hhd, Hhd^Fp, Md, Ha^Esa, Hhd, Ms^Xm, Ha^Fpa, Ms, Ms, Ha^Esa, Ms^Xm, Ms^Xm
Ss, Ss, Sm, Sm, Sm, Coa, Coa, Koa, Rp, Rp, Aa^Esa, Isa, Isa, Aa, Aa, Co, Wwg, Wwg, Ha, Md, Ms, Hhd^Voa, Hhd, Hhd, Hhd, Aa^Fpa, Aa, Aa^Esa, Gd, Gd, Gd, Gd, Aa, Rp, Ker, Gd, Gd, Aa, Aa, Aa, Gd, Gd, Gd, Rb, Rb, Rb, Hhd, Ms^Xm, Md, Hhd, Ha, Ms^Xm, Ha, Ms, Ha^Voa, Ms, Ms^Xm, Ms^Xm
Ss^Vo, Ss, Gs, Coa^Voa, Coa, Coa, Koa, Coa, Coa, Coa^Voa, Aa, Gd, Isa^Ecf, Isa, Gs, Wwg, Coa, Wwf, Sm, Ha, Ms, Ms, Ms, Hhd^Voa, Hhd, Aa, Aa^Fpa, Aa^Fpa, Gd, Gd, Rb^Voa, Aa, Aa, Cer, Cer, Gd, Aa, Gd, Aa, Aa^Fpa, Gd, Gd, Gd, Gd, Rb, Rb, Ha, Ha, Hhd, Ha, Chr, Md, Ms, Hhd, Ms, Ha, Ms, Ms
Sm, Sm, Rp^Em, Coa, Rp, Coa, Coa^Voa, Coa, Rp, Coa, Rp^Es, Gd, Gll^Fdw, Isa, Gs^Es, Re, Aa, Co, Sm, Hhd, Coa, Md, Ms, Ms, Hhd, Ha, Ha^Fp, Aa^Fpa, Gd, Gd, Gd, Gd, Aa, Gd, Gd, Gd, Aa^Es, Aa, Gd, Gd, Gd, Gd, Gd, Gd, Rb, Hhd, Md, Hhd, Hhd, Hhd^Fp, Md^Xm, Md, Ms, Ms, Ms, Ms, Ms^Xm, Ms
Isa, Rp, Rd, Isa^Ecf, Isa, Koa, Gs^Es, Coa, Coa, Rp, Isa, Gs, Isa, Isa, Isa, Gs, Aa, Co, Wwg, Hhd, Hhd, Md, Ha, Hhd, Co, Hhd, Gd, Gd, Gd, Gd, Gd, Gd, Isa, Gd, Gd, Gd, Gd, Aa, Gd, Gd, Gd, Gd, Rb, Rb, Hhd, Hhd^Fp, Ms^Xm, Ms, Ha, Ms, Ms, Ms, Md^Xm, Ms, Ms, Ms^Xm, Ms, Ms
Gs, Rb, Aa, Rd, Isa, Rp, Gs, Coa, Gs, Gs, Aa^Voa, Isa, Isa, Rb, Rb, Isa, Aa^Voa, Isa, Isa, Sm, Rb^Em, Ha, Isa, Hhd, Rp, Gd^Es, Isa, Rp, Rp, Rp, Rp, Isa, Gd, Gd, Gd, Gd, Aa, Gd, Gd, Gd, Gd, Rb, Rb, Hhd, Ha, Ms, Ms^Xm, Ms, Ha, Ms, Ha, Hhd^Fp, Ms^Xm, Ms, Ms, Ms, Ms, Ms
Gs, Gs^Es, Gll^Fdw, Aa^Esa, Isa, Isa, Isa, Rp, Isa, Isa, Isa, Isa, Aa, Aa, Rb, Isa, Rp, Rp, Rp, Isa, Rp, Isa, Hhd, Rp, Co, Isa, Gd, Aa, Gd, Gd, Gd, Aa, Aa, Gd, Gd, Aa, Gd, Gd, Gd, Gd, Rb, Rb, Ha, Ha, Ms, Md, Md, Md, Hhd, Md, Ha, Ms, Ms, Ms, Ms^Xm, Ms, Ms, Ms^Xm
Wwf, Wwg, Aa^Voa, Isa, Aa, Rb, Isa, Isa, Rp^Ecf, Rd, Isa, Rb, Aa, Aa, Aa, Rb, Ss, Wwg, Ss, Sm, Co, Hhd, Ms, Hhd, Hhd, Ha, Gd, Gd, Gd, Gd, Gd, Gd, Aa, Aa^Esa, Aa, Gd, Gd, Gd, Aa, Rb, Aa, Aa, Ha, Ha^Fpa, Md^Xm, Ms^Xm, Hhd, Md, Hhd, Ha, Ha^Esa, Ms, Ms, Ms, Ms, Ms, Ms, Ms
Ss, Sm, Gd, Aa^Es, Gs, Rb, Isa, Rd, Gs, Rd, Gs, Isa, Aa^Voa, Aa^Esa, Rd, Gs, Coa, Ss, Hhd, Hhd, Md, Md, Hhd, Hhd^Voa, Hhd, Ha^Es, Gd, Gd, Aa, Gd, Aa^Fpa, Gd, Gd^Es, Rb, Gd, Gd, Gd, Gd, Gd, Rb, Aa, Hhd, Ha, Md, Md, Chr, Hhd, Hhd, Md, Ha^Fpa, Md, Ms, Md^Xm, Ms, Md^Xm, Ms, Md^Xm, Ms
Ss, Co, Wwg, Gd, Wwf, Gs, Rp, Rp, Re, Gs, Gd, Isa, Rd, Re, Wwg, Co, Wwg, Hhd, Hhd, Hhd^Fp, Ms, Md, Hhd, Hhd, Ha, Gd, Gd, Gd, Aa, Aa, Aa, Gd, Gd, Rb, Gd, Gd, Gd, Gd, Aa, Rb, Hhd, Hhd, Hhd, Hhd, Hhd, Hhd, Hhd, Md, Md, Md, Md^Xm, Md^Xm, Xu, Ms^Xm, Xu, Ms^Xm, Ms^Xm, Ms^Xm
Ss, Sm, Sm, Wwg, Co, Co, Coa, Re, Wwg, Re, Co, Rp, Co, Wwg, Ss, Ss, Hhd, Hhd, Ms, Ms, Ha, Ha, Hhd, Ha, Gd, Gd, Aa^Voa, Aa^Esa, Aa, Gd, Gd, Gd, Gd, Rb, Gd, Gd, Gd, Aa, Aa^Fpa, Aa, Hhd, Hhd, Hhd, Hhd, Hhd, Hhd, Md, Md, Md, Md, Md, Xu, Uh, Xu, Uh, Md^Xm, Xu, Ms^Xm
Ss, Sm, Sm, Ss, Sm, Sm, Ss, Ss, Sm, Co, Ss, Rb, Sm, Sm, Ss, Hhd, Hhd^Fp, Ms, Ms, Ms, Hhd, Hhd, Gd, Gd, Gd, Aa, Aa^Fpa, Aa, Gd, Gd, Gd, Gd, Gd, Rb, Rb, Gd, Gd, Gd, Aa^Fma, Ha, Ha^Fpa, Ha^Voa, Ms^Xm, Hhd, Hhd, Ha, Md, Md, Ms^Xm, Ms^Xm, Xu, Uh^Vu, Cte, Cte, Cte, Uh, Xu, Xu
Ha, Ss, Hhd, Ss, Hhd, Hhd, Hhd, Hhd, Hhd, Ss, Hhd, Ss, Ha, Ha, Coa^Voa, Md, Md, Md, Hhd, Hhd, Ha, Ha, Gd, Gd, Gd, Gd^Fp, Gd^Fp, Gd, Gd, Gd, Gd, Gd, Gd, Gd, Cer^Esa, Rb, Gd, Gd^Fms, Gd^Fp, Ha, Ha, Md, Md, Md, Ha^Fpa, Ha, Md, Md, Ms^Xm, Xu, Xu, Sm, Sm, Kte, Uu, Uu^Vu, Uu, Uu
Hhd, Hhd^Fms, Hhd^Voa, Hhd^Fp, Ms, Ms, Ms, Hhd, Ha, Hhd, Co, Hhd, Hhd^Fms, Ms, Ha, Md, Hhd, Hhd, Hhd, Hhd, Gd, Gd, Gd, Gd, Gd, Gd, Gd, Gd, Gd, Gd, Gd, Aa^Esa, Aa, Aa, Ker, Rb, Aa^Esa, Gd, Aa^Fpa, Hhd, Ha, Md, Ms, Ms, Md, Ha, Chr, Md, Hhd, Ha, Uh, Uu, Uu, Cte, Uu, Uu, Uh, Uu
Ms, Ms, Ms, Ha^Fp, Ms, Ms, Hhd, Md, Md, Md, Ha, Md, Ms, Ms, Ha^Esa, Hhd, Rb, Hhd, Gd, Gd, Gd, Gd, Gd, Gd, Gd, Gd, Gd, Gd, Gd, Gd, Gd, Aa^Voa, Aa, Cer^Esa, Rb, Rb, Aa^Esa, Aa, Gd, Gd, Hhd, Hhd, Ms, Ms, Md^Xm, Ha, Hhd, Hhd, Hhd, Hhd, Ms, Uh, Sm, Sm, Uh, Uu, Uh, Xu
Hhd, Ms, Ha, Md, Hhd, Hhd, Hhd, Hhd^Voa, Ha, Md, Hhd, Hhd, Hhd, Ha, Hhd, Hhd, Rb, Rb, Gd, Gd, Gd, Ha^Fpa, Hhd, Hhd, Gd, Gd, Gd, Gd, Gd, Gd, Gd, Gd, Rb, Rb, Gd, Aa, Aa, Gd, Gd, Gd, Hhd, Hhd, Hhd, Md, Ms, Hhd, Hhd, Hhd, Md, Ms, Xu, Uh^Vu, Uh, Uu, Uh, Uh, Xu, Xu
Hhd, Hhd, Hhd, Ha^Esa, Gd, Hhd, Ha, Ha, Ha, Ha, Rb, Ha, Ha, Hhd, Aa, Rb, Gd, Gd, Gd, Gd, Gd, Ha^Esa, Ha, Hhd, Gd, Gd, Gd, Gd, Gd, Gd, Rb, Rb, Gd^Es, Gd, Gd, Gd, Gd, Gd, Aa^Fma, Gd, Hhd, Hhd, Ha, Chr, Ms, Hhd, Hhd, Hhd^Fp, Md, Ms^Xm, Ms^Xm, Xu, Ms, Xu, Xu, Xu, Xu, Xu
Hhd, Hhd, Gd, Gd, Gd, Gd, Gd, Rb, Rb, Rb, Rb, Re, Gd, Aa, Cer, Rb, Gd, Gd, Hhd, Gd, Gd, Hhd, Hhd, Hhd, Gd, Gd, Aa, Aa^Esa, Rb, Rb, Gd, Gd, Gd, Gd, Gd, Gd, Re, Rb, Aa, Aa, Gd, Hhd, Ha^Fma, Ha, Hhd, Hhd, Ha, Ha^Voa, Ms, Ms, Ms^Xm, Ms, Ms^Xm, Ms^Xm, Ms^Xm, Xu, Ms^Xm, Ms^Xm
Ha, Hhd, Gd, Gd, Hhd, Gd, Hhd, Gd, Cer, Rb, Gd, Gd, Gd, Aa, Gd, Gd, Ha, Hhd, Ha^Fpa, Ha, Gd, Gd, Gd, Gd, Gd, Aa^Es, Aa, Aa, Rb, Gd, Gd, Gd, Gd, Gd, Gd, Aa, Aa^Fma, Rb, Aa, Aa^Esa, Aa, Gd, Ha, Hhd, Hhd, Hhd, Ha, Ms^Xm, Ms, Ms, Md, Md, Md, Ms^Xm, Ms^Xm, Ms^Xm, Ms^Xm, Ms^Xm
Ha, Gd, Gd, Gd, Md, Gd, Hhd, Hhd, Aa, Ker, Aa, Gd, Gd, Gd, Gd, Gd, Ha^Esa, Hhd, Ha, Ha, Gd, Gd, Gd, Aa, Aa^Fpa, Aa^Fpa, Aa^Voa, Aa^Esa, Aa, Gd, Gd, Gd, Gd, Gd, Gd, Gd, Gd, Rb, Aa, Aa, Gd, Gd, Gd, Ha, Gd, Hhd, Hhd, Ha^Fp, Md, Md, Md, Md, Md, Md, Md, Ms^Xm, Ms^Xm, Ms^Xm
Ha, Gd, Gd, Hhd, Ha, Ms, Ms, Ha, Ha, Aa, Gd, Gd, Aa, Aa, Gd, Ha^Fpa, Ha, Hhd, Aa, Ha^Esa, Gd, Gd, Gd, Gd, Aa, Aa^Fpa, Aa, Aa, Aa, Aa, Rb, Gd^Es, Rb, Gd, Gd, Gd, Gd, Gd, Gd, Gd, Gd, Gd, Gd^Efm, Gd, Gd, Hhd, Hhd, Hhd, Hhd, Ms, Ms, Md, Ms, Md, Ms, Md, Ms, Ms^Xm
Hhd, Hhd, Gd, Ha, Ha, Md, Hhd, Hhd, Aa, Gd, Gd, Gd, Aa, Cer, Gd, Gd, Gd, Aa, Gd, Gd, Gd, Gd, Gd, Gd, Gd, Gd, Gd, Gd, Gd, Gd^Es, Gd, Rb, Gd, Rb, Rb, Rb, Rb, Gd, Gd, Gd, Gd, Gd, Gd, Gd, Gd, Gd, Gd, Hhd, Gd, Hhd, Ha, Ms, Chr, Md, Md, Md, Md, Ms
Hh^Fms, Hhd, Gd, Gd, Gd, Hhd, Ha, Ha, Aa, Gd, Aa^Voa, Aa, Aa, Gd, Gd, Aa, Gd, Gd, Gd, Gd, Gd, Gd, Gd, Gd, Gd, Gd, Gd, Gd, Rb, Gd, Gd, Gd, Gd, Gd, Gd, Gd^Es, Gd, Rb, Gd, Gd, Gd, Gd, Aa, Gd, Gd, Gd, Gd, Gd, Gd, Hhd, Hhd, Ha, Ha, Ms^Xm, Ms, Md, Ms, Ms
Aa^Fpa, Aa^Fpa, Hhd^Fms, Gd, Cer^Esa, Gd, Gd, Aa, Gd, Gd, Aa, Aa, Gd, Gd, Gd, Gd, Gd, Gd, Aa, Gd, Aa, Ha, Ha^Fpa, Aa, Aa^Esa, Aa, Aa, Rb, Rb, Re, Re, Gd, Gd^Fms, Gd, Gd, Gd, Gd, Aa, Aa^Esa, Gd, Aa, Aa, Aa^Fpa, Aa, Aa, Gd, Gd, Gd, Gd, Gd, Ha, Ha^Esa, Hhd, Ha^Fma, Ms, Ms, Ms, Md
Aa^Fpa, Aa^Fpa, Aa^Fma, Cer^Esa, Ker, Cer, Gd, Gd, Gd, Gd, Gd, Gd, Gd, Gd, Gd, Gd, Gd, Gd, Aa, Aa^Esa, Ha, Ha, Aa, Aa, Gd, Aa^Voa, Rb, Rb, Rb, Re, Gd, Gd, Gd^Fms, Aa^Fpa, Aa, Gd, Gd, Rb, Aa, Aa^Wm, Aa, Aa^Fpa, Aa, Aa, Aa, Aa^Esa, Gd, Gd, Gd, Gd, Gd, Ha, Ha, Hhd, Ha^Voa, Ms, Ms, Md
Ha, Ha^Esa, Hhd, Cer, Gd^Efm, Cer^Esa, Gd, Gd, Gd, Gd, Gd, Gd, Gd, Gd, Gd, Gd, Gd, Gd, Aa, Ha^Fpa, Ha^Esa, Ha^Esa, Hhd, Gd, Gd, Aa, Rb, Rb, Gd, Gd, Gd, Gd, Gd, Aa, Aa^Esa, Aa, Rb, Rb, Aa^Fpa, Re, Gd, Aa, Aa, Aa^Voa, Aa, Aa, Aa^Fma, Gd, Gd, Gd, Gd, Gd, Ha, Hhd, Md, Md, Ms, Ms
Ms, Ms, Ms, Ha, Ms, Hhd, Ha, Hhd, Gd^Efm, Gd, Gd, Gd, Gs^Fms, Gd^Efm, Gs^Fms, Gd, Gd, Gd, Aa, Ha, Ha, Hhd, Gd, Gd, Gd, Gd, Gd, Gd, Gd, Gd, Rb, Rb^Es, Rb^Es, Gd, Aa, Aa^Fpa, Gd, Rb, Re, Re, Gd, Aa, Aa, Aa, Gd^Esa, Aa, Aa^Fpa, Gd, Gd, Gd, Gd, Gd, Hhd, Md, Ms, Md, Ha^Fma, Md
Ms, Ms, Ms, Ms, Ms, Ms, Ms, Ha^Esa, Hh^Fms, Gd^Fms, Aa^Fpa, Gll^Fp, Aa^Fpa, Gll^Fp, Aa^Fpa, Gll^Fp, Gs^Fms, Gd, Gd, Gd, Gd, Gd, Gd, Gd, Aa, Aa, Rb, Gd, Rb, Rb, Gd, Gd, Gd, Rb, Aa, Aa, Gd, Rb, Gd, Gd, Rb, Rb, Re, Re, Aa, Aa, Gd, Gd, Gd, Gd, Gd, Gd, Gd, Hhd, Ha, Ha^Esa, Ha, Ha
Ms, Ms, Ms, Ms, Ms, Ms, Ms, Ha, Hhd^Fp, Ha^Fma, Aa^Fpa, Gll^Fp, Gll^Fp, Aa^Fpa, Gs^Fms, Gs^Fms, Aa^Fpa, Aa^Fpa, Aa^Fma, Gd, Gd, Gd, Rb, Gd, Aa, Rb, Gd, Rb, Re^Edt, Gd, Gd, Gd, Gd, Aa^Fpa, Gd, Aa^Esa, Aa, Aa^Voa, Gd, Re, Aa^Fma, Rb, Re, Re, Re, Re, Re, Gd, Cea, Gd, Gd, Gd, Gd, Gd, Hhd, Ha, Gd, Ha
Ms, Ms, Hhd^Fms, Ha, Ha^Fma, Ms, Ha^Fma, Ha^Fp, Hhd^Fp, Hhd^Fms, Aa^Fpa, Aa^Fpa, Aa^Fms, Gll^Fp, Gs^Fms, Aa^Fpa, Aa^Fma, Aa^Fma, Gs^Fms, Gll^Fp, Gd, Rb, Gd, Aa, Aa^Esa, Aa, Gd, Gd, Re^Edt, Re^Edt, Gd, Gd, Gd, Gd, Gd, Gd, Gd, Gd, Gd, Aa, Aa, Aa, Aa, Aa, Gd, Gd, Cea, Cea, Gd, Gd^Efm, Gd, Gd, Gd, Gd, Gd, Gd, Gd, Hh
Ha^Fpa, Ha^Fpa, Ha^Fpa, Hhd^Fp, Hhd^Fms, Hhd^Fp, Hhd^Fms, Hhd^Fp, Hhd^Fms, Hhd^Fms, Aa^Fpa, Gll^Fma, Gs, Gs^Fms, Gll^Fp, Aa^Fma, Gs^Fms, Gll^Fp, Gs^Fms, Gs^Fms, Gd, Rb, Gd, Aa^Fp, Aa, Aa^Voa, Gd, Re^Edt, Gd, Gd, Gd, Gd, Gd, Gd, Gs^Fms, Gs^Fms, Gd, Gd, Gd, Gd, Re, Re, Gd, Gd, Gd, Gd, Cea, 2 Kea, Aa, Gd, Gd, Gd, Gd, Gd^Efm, Gd, Gd, Gd, Gd
Hhd^Fms, Ha^Fpa, Hhd^Fp, Hhd^Fms, Hhd^Fp, Hhd^Fp, Hhd^Fms, Ha^Fma, Hhd^Fp, Gll^Fp, Gll^Fp, Gll^Fp, Gd, Gs, Gd^Efm, Gll^Fp, Gs^Fms, Gs^Fms, Gll^Fp, Gd, Gd, Rb, Gd, Gd, Gd, Gd, Gd, Gd, Gd, Gd, Gll^Fp, Gs^Fms, Gll^Fp, Gs^Fms, Gll^Fp, Gll^Fp, Gll^Fp, Gd, Gs^Fms, Gd, Gd, Re, Gd, Gd, Gd, Gd, Gd, Gd, Gs^Fms, Gd, Gd, Gd, Gd, Gd, Gd, Gd, Gs^Fms, Gd
Hhd^Fp, Hhd^Fp, Ha^Fpa, Ha^Fpa, Ha^Fpa, Ha^Fma, Aa^Fma, Gll^Fp, Gll^Fp, Gs, Gs, Gd, Rb, Gs, Aa, Gd, Gd, Gd, Gd, Gd, Rb, Rb, Gd, Gd, Aa^Fpa, Gd, Gs^Fms, Gd, Gs^Fms, Gll^Fp, Aa, Gll^Fp, Aa, Gd, Gll^Fp, Aa, Aa, Gll^Fp, Gs^Fms, Gd, Aa, Gd, Gd, Gd, Gd, Gd, Gs^Fms, Gs^Fms, Aa^Fma, Gd, Gll^Fp, Gs^Fms, Aa^Fpa, Gs^Fms, Aa^Fma, Gs^Fms, Gs^Fms, Gs^Fms
Ha^Fpa, Hhd^Fms, Hhd^Fp, Ha^Fpa, Gg^Fp, Gs^Fms, Gd^Efm, Gs, Rb, Gs, Rb, Rb, Gd, Rb, Aa, Gd, Rb, Gd, Gd, Gd, Rb, Gd, Gd, Gs^Fms, Gll^Fp, Aa^Fpa, Gll^Fp, Aa^Fma, Aa^Fpa, Aa^Fpa, Aa^Fms, Aa^Fma, Aa, Aa^Fma, Gll^Fp, Gd, Aa^Fpa, Aa^Fpa, Aa^Fpa, Gd, Aa, Cea, 1 Kea, Cea, Gd, Gd, Gs^Fms, Gs^Fms, Gll^Fp, Gs^Fms, Gll^Fp, Aa^Fpa, Gll^Fp, Aa^Fma, Aa^Fpa, Gs^Fms, Gs^Fma, Gll^Fp
Ha^Fpa, Hhd^Fp, Gs, Gd^Es, Gd, Gd, Rb, Rb, Gs^Fms, Rb, Gs^Fms, Gd, Aa^Fma, Aa^Fpa, Gs^Fms, Rb, Aa, Rb, Aa^Esa, Rb, Gd, Gd, Gll^Fp, Gs^Fms, Gd, Gd, Gs^Fms, Aa^Fpa, Aa^Fma, Gs^Fms, Gll^Fp, Gd, Gll^Fp, Aa, Gll^Fp, Gll^Fp, Gg^Fp, Gll^Fp, Gll^Fp, Gs^Fms, Gll^Fp, Gd, Cea, Cea, Gd, Gd, Gll^Fp, Aa^Fma, Aa^Fpa, Aa, Gs, Gs^Fms, Gll^Fp, Aa^Fpa, Aa^Fma, Aa^Fpa, Aa^Fma, Gs^Fms
Gs, Gs, Aa, Gd, Rb, Rb, Sm, Aa^Fpa, Sm, Gs^Fms, Aa^Fma, Aa^Fpa, Aa^Fma, Aa^Fpa, Gll^Fp, Aa^Fma, Aa, Aa, Aa, Gd, Gd^Efm, Gll^Fms, Aa^Fpa, Gs^Fms, Aa^Esa, Gs^Fms, Gs^Fms, Gs^Fms, Aa, Gd, Gs^Fms, Aa, Aa, Aa^Fma, Aa^Fma, Gll^Fp, Gll^Fp, Gll^Fp, Gs^Fms, Gd, Aa^Fpa, Gd, Gd, Gd^Efm, Gd, Gg^Fp, Aa^Fma, Aa^Fma, Aa^Fpa, Aa^Vea, Aa^Fpa, Aa^Fpa, Gs^Fms, Gs, Aa, Aa^Fpa, Gll^Fp, Gll^Fp
Rb, Rb, Aa^Fpa, Aa, Aa^Fpa, Sm, Gs^Fms, Aa^Fpa, Sm, Ss, Sm, Gs^Fms, Gs^Fms, Aa^Fma, Aa, Gs^Fms, Aa^Fma, Aa^Vea, Aa^Fma, Aa, Aa^Fma, Aa^Fma, Gll^Fms, Gll^Fp, Aa^Fpa, Gs^Fms, Aa, Gll^Fp, Aa, Aa, Gs^Fms, Gll^Fp, Aa^Esa, Aa^Fma, Gs^Fms, Gll^Fp, Aa^Fma, Gll^Fp, Aa^Fp, Gs^Fms, Gg^Fp, Aa, Gd, Gd, Gd, Gd, Gd, Gll^Fp, Gll^Fp, Aa^Fpa, Gll^Fp, Gs^Fms, Gll^Fp, Gs, Gll^Fp, Gll^Fp, Gg^Fp, Gll^Fp
Aa, Aa, Aa, Aa^Fpa, Ss, Aa^Fpa, Gs^Fms, Ss, Aa^Fpa, Ss, Gll^Fp, Aa^Fpa, Gll^Fp, Gd, Aa^Fma, Gll^Fp, Gs^Fms, Aa^Fpa, Aa^Fma, Aa^Fma, Gll^Fp, Aa^Fma, Gs^Fms, Gll^Fp, Aa^Fpa, Aa^Fpa, Aa^Fpa, Gll^Fp, Gs^Fms, Gs^Fms, Gs^Fms, Aa^Fpa, Gs^Fms, Gs^Fms, Aa^Fpa, Gs^Fms, Gs, Aa^Fma, Gs^Fms, Gll^Fp, Gs^Fms, Aa, Gd, Gd, Gd, Gd, Gs^Fms, Gs^Fms, Aa^Fpa, Gs^Fms, Aa^Fpa, Gs^Fms, Aa^Fpa, Gll^Fp, Gll^Fp, Aa^Fma, Aa^Fpa, Gll^Fp
Aa^Fms, Gll^Fma, Aa^Fpa, Ss, Sm, Sm, Aa, Gs^Fms, Sm, Gll, Ss, Ss, Gll^Fp, Aa^Fma, Gs^Fms, Aa^Fma, Gll^Fp, Gll^Fma, Gll^Fp, Aa^Fma, Gs^Fp, Gll^Fp, Gll^Fp, Aa^Fma, Aa, Aa^Fma, Aa^Fpa, Gs^Fms, Gs^Fms, Gs^Fms, Aa^Fpa, Aa^Fpa, Aa^Fpa, Gll^Fp, Aa, Aa, Gs, Gs^Fms, Gs^Fms, Gs^Fms, Aa, Gd, Gd, Gd, Gd, Aa^Fma, Aa^Fma, Aa, Gs, Aa, Gll^Fp, Gs^Fms, Aa^Fma, Aa^Fpa, Aa^Fpa, Aa^Fma, Aa^Fpa, Gll^Fp
Aa^Fma, Aa^Fma, Aa^Fma, Aa^Fma, Aa^Fpa, Aa^Fpa, Gs^Fms, Ss, Aa^Fpa, Gs^Fms, Aa, Aa^Fpa, Gs^Fms, Gll^Fp, Aa, Gll^Fp, Aa^Fma, Gll^Fp, Gs^Fms, Gg^Es, Gs^Fms, Gs^Fp, Gs^Fms, Aa^Fma, Gs^Fp, Gs^Fms, Gg^Fms, Aa, Gg^Fp, Aa^Fpa, Gs^Fms, Gs^Fms, Gll^Fp, Gs^Fms, Aa^Fpa, Gg^Fms, Gs, Aa^Esa, Gs^Fms, Gs^Fms, Aa, Gd, Gll^Fp, Gd, Gd, Gd, Gs^Fms, Gs, Gs^Fms, Gll^Fp, Gs^Fms, Aa^Fma, Aa^Fpa, Aa^Fpa, Aa^Fpa, Aa^Fpa, Gll^Fp, Aa^Fpa
Aa^Fp, Gs^Fms, Aa^Fms, Gll^Fp, Aa^Fms, Gs^Fms, Gll^Fp, Gll^Fp, Gll^Fp, Gs^Fms, Aa, Gll^Fp, Aa^Fp, Aa, Aa^Fms, Gll^Fp, Aa^Fms, Gll^Fp, Aa^Fp, Gg, Gg, Gs^Fms, Gs^Fms, Aa^Fma, Gg, Gs^Fms, Gs^Fms, Gg^Fp, Gg, Gg^Fp, Gg^Fp, Gll^Fp, Gg, Gll^Fp, Gs, Gs, Aa, Aa, Gs^Fms, Gg^Fms, Gll^Fp, Gs^Fms, Gd, Gd, Gd, Gd, Gs^Fms, Gll^Fp, Gll^Fp, Gs^Fms, Gll^Fp, Aa, Gll^Fp, Aa^Fma, Gll^Fp, Aa^Fma, Gll^Fp, Aa^Fp
