Md, Md, Md, Md, Md, Md, Ms, Gs, Md, Gg, Ms^Xm, Gs, Md, Rb, Ms^Xm, Ms^Xm, Ms^Xm, Ss, Hhd, Wwg, Ha, Wwg, Wwg, Hhd, Md, Ms, Md, Md, Md, Hhd, Hhd, Gll, Gd, Gll, Gd, Gd, Gll, Rb, Rrc, Rrc, Rp, Aa, Aa, Rb, Gd, Gd, Gll, Gd, Hhd, Md, Ms, Md, Md, Ms, Ms, Md, Ms, Ms^Xm, Ms, Ms^Xm, Ms^Xm, Ms, Ms, Ms^Xm, Ms^Xm, Ms^Xm, Ms, Ms^Xm, Ms^Xm, Ms^Xm
Md, Md, Ms, Ms, Ms^Xm, Ms^Xm, Md, Md, Md, Ms^Xm, Ms^Xm, Md, Md, Md, Md, Ms^Xm, Md, Md, Ms, Ha, Ha, Hhd, Wwg, Hhd, Ha, Ha, Md, Md, Md, Hhd, Hhd, Aa^Esa, Aa, Gd, Gd, Gd, Gd, Gll, Gd, Aa, Gd, Rp, Rrc, Rrc, Gd, Gd, Gd, Gd, Hhd, Ha, Ha^Esa, Md, Md, Md, Ms, Ms, Ms, Ms, Ms, Ms, Ms, Ha^Esa, Ha^Esa, Ms^Xm, Ms, Ms, Ms, Ms, Ms^Xm, Ms^Xm
Ms, Ms, Ms, Ms, Ms^Xm, Ms^Xm, Md, Md, Md, Ms, Ms, Ms, Md, Md, Wwf, Aa^Esa, Wwf, Ha, Ha, Ms, Ha^Esa, Hhd, Wwg, Sm, Sm, Ha^Esa, Hhd, Md, Ms, Ms, Ha, Hhd, Ha, Gd, Hhd, Gll, Gd, Aa, Aa, Gd, Gd, Ce, Ce, Ce, Ce, Gll, Gd, Gd, Gd, Ha, Ha, Md, Md, Md, Ms, Ms, Ms, Ms, Ms, Ms, Ms, Ha, Ha, Ha, Ms^Xm, Ms, Ms, Ms^Xm, Ms^Xm, Ms^Xm
Ms, Ms, Ms, Ms^Xm, Ms, Md, Ms, Md, Md, Ms, Md, Md, Md, Wwf, Md, Wwf, Md, Wwg, Wwg, Ha, Wwg, Ha, Ha, Wwg, Wwg, Ha, Hhd, Ms, Ms, Ms, Ms, Md, Md, Ha, Hhd, Gd, Gd, Aa^Esa, Gd, Aa, Gd, Ce, Ce, Ce, Ce, Aa^Esa, Gll, Gd, Gd, Gll, Gd, Hhd, Md, Ms, Ms, Ms, Ms, Ms, Ms, Ms, Ms, Ms, Ms, Ms^Xm, Ms^Xm, Ms, Ms, Ms, Ms, Ms^Xm
Ms, Ms, Ms, Ms, Ms, Ms, Ha^Fpa, Ha, Ha, Md, Rr, Md, Coa, Md, Coa, Md, Isa, Co, Co, Wwg, Md, Wwg, Wwg, Wwg, Co, Wwg, Hhd^Fp, Ha^Fp, Md, Md, Ms, Ha, Ha^Esa, Hhd, Hhd, Hhd, Hhd, Gd, Gd, Gd, Aa, Gd, Gd, Ket, Ce, Aa, Gd, Aa, Aa, Aa^Fpa, Hhd, Ha^Esa, Chr, Md, Md^Xm, Ms, Ms^Xm, Ms, Ms, Ms, Ha^Esa, Ms, Ms, Ms, Ms, Ms^Xm, Ms^Xm, Ms, Ms^Xm, Ms^Xm
Md, Md, Ms, Ms, Ms, Ms, Ha^Fpa, Ha, Rp, Coa, Ss, Rp, Isa, Isa, Rp^Em, Isa, Isa, Rrc^Vo, Isa, Gd^Es, Rp, Coa, Co, Aa, Rb, Wwg, Wwg, Hhd^Fp, Ha, Coa, Ms, Ha^Voa, Ha, Ha, Hhd, Hhd, Gll, Gd, Gd, Aa^Fpa, Aa^Fpa, Gd, Aa^Esa, Gd, Gd, Rrc, Rrc, Gd, Gd, Aa^Fpa, Gd, Hhd, Hhd, Hhd^Fpa, Hhd, Ha^Voa, Ms, Ms, Ms, Ha, Ha, Ha^Esa, Ha^Fpa, Ms, Ms, Ms^Xm, Ms^Xm, Ms^Xm, Ms, Ms
Ms^Xm, Md, Ms, Ms, Ms, Ms, Aa, Aa, Rr, Rb, Ss, Ss, Wwf, Aa^Esa, Aa, Rb, Rb, Isa, Rp, Isa, Isa, Isa, Isa, Rb, Rb, Co, Coa, Wwg, Hhd, Ha, Ms, Ms, Ms, Ha, Hhd, Gd, Gd, Gd, Gll, Aa, Aa, Aa, Aa^Fma, Aa^Fpa, Gd, Aa, Aa^Esa, Aa, Aa, Gd, Gd, Gll, Gd, Rb, Hhd, Hhd, Hhd, Ms, Ha^Esa, Ha, Ms, Hhd^Fpa, Ms, Hhd, Ms, Ms, Ms, Ms, Ms, Ms
Ms^Xm, Ms^Xm, Ms, Ms, Md, Md, Md, Coa, Rb, Ss, Sm, Sm, Sm, Wwf, Wwf, Rb, Coa, Co, Rp, Rb, Isa, Rp, Aa, Rb, Rb, Co^Vo, Re, Wwg, Wwg, Hhd, Hhd^Fp, Ms, Md, Ha, Hhd, Hhd, Gll, Aa, Aa, Aa, Aa, Aa, Aa, Aa^Fpa, Cer, Gd, Rp, Aa, Aa, Gd, Gd, Gll, Gd, Gd, Aa, Hhd, Rb, Hhd, Hhd, Hhd^Fpa, Ms, Ha, Hhd^Esa, Ms^Xm, Ha^Fpa, Ms, Ms, Ha, Ms^Xm, Ms^Xm
Md, Ms, Ms, Ms, Md, Md, Wwf, Coa, Rb^Es, Ss, Ss, Sm, Ss, Ss, Wwf, Wwf, Wwf, Co, Co, 1 Ko, Rp, Rp, Rb, Aa, Isa, Rb, Gd, Co, Wwg, Wwg, Hhd, Md, Ms, Ha^Vo, Ha, Hhd, Hhd, Aa^Fpa, Aa, Aa^Esa, Gd, Gd, Gll, Gll, Aa, Rp, Rb, Re, Ce, Gd, Aa, Aa, Gd, Gd, Aa, Aa, Rb, Aa, Hhd, Ms^Xm, Ms, Ha, Hhd, Ms^Xm, Ha, Ms, Hhd^Voa, Ms, Ms^Xm, Ms^Xm
Md, Md, Md, Md, Aa, Rb, Wwf, Rp, Wwf, Wwf, Sm, Sm, Ss^Vo, Wwf, Gd, Co^Vo, Co, Co, Ko, Coa, Co, Co^Vo, Rb, Gs, Isa, Isa, Gs, Wwg, Coa, Wwf, Wwf, Hhd, Ms, Ms, Ms, Hhd^Voa, Hhd, Aa, Aa^Fda, Aa^Fpa, Gd, Gll, Aa^Voa, Aa, Aa, Rb, Rb, Ce, Ce, Ket, Aa, Aa^Fpa, Gll, Gd, Aa, Aa, Rb, Aa, Hhd, Hhd, Hhd, Hhd, Chr, Ms, Ms, Hhd, Ms, Ha, Ms, Ms
Ms^Xm, Md, Md, Ms, Ms, Aa^Esa, Wwf, Coa, Wwg, Wwg, Wwg, Sm, Wwf, Wwf, Rp^Em, Coa, Rp, Co, Co^Vo, Co, Rp, Co, Rp^Es, Rb, Gd, Isa, Gs^Es, Re, Aa, Co, Sm, Hhd, Coa, Md, Ms, Ms, Hhd, Ha, Ha^Fpa, Aa^Fda, Aa, Gd, Gll, Aa, Aa, Rb, Re, Rb, Ce, Ce, Ce, Gd, Gd, Gd, Gd, Gd, Gd, Hhd, Md, Hhd, Hhd, Ha^Fp, Md^Xm, Ms, Ms, Ms, Ms, Ms, Ms^Xm, Ms
Ms^Xm, Ms^Xm, Md, Ms, Ms, Ms, Ms, Wwf, Wwg, Wwg, Co, Wwg, Aa, Rp, Rb, Isa, Rp, 2 Ko, Gs^Es, Co, Coa, Rp, Isa, Aa, Aa, Aa, Isa, Gd, Aa, Co, Wwg, Hhd, Hhd, Md, Hhd, Hhd, Hhd, Hhd, Gd, Gd, Gd, Aa, Gll, Gd, Rrc, Gd, Gd, Gd, Aa, Ce, Gd, Gd, Gd, Gd, Gll, Gd, Hhd, Hhd^Fp, Ms^Xm, Ms, Ha, Ms, Ms, Ms, Md^Xm, Ms, Ms, Ms^Xm, Ms, Ms
Md, Md, Ms, Ms, Ms, Ms, Md, Md, Md, Wwg, Wwg, Co, Aa, Rb, Rb, Rb, Aa, Rp, Rd, Coa, Rb, Rb, Gd^Vo, Isa, Isa, Re, Rb, Isa, Rrc^Vo, Rrc, Rrc, Wwf, Rb^Em, Hhd, Rrc, Hhd, Rp, Gd, Rrc, Rp, Rp, Rp, Rp, Rrc, Gd, Gd, Gll, Aa, Aa, Aa, Aa, Gd, Gd, Gd, Rb, Hhd, Ha, Ms, Ms^Xm, Ms, Ha^Esa, Ms, Ha^Esa, Hhd^Fp, Ms^Xm, Ms, Ms, Ms, Ms, Ms
Md, Md, Md, Ms, Md, Ms, Ms, Ms, Ms, Sm, Wwg, Rb, Gs, Rb, Gs, Aa, Aa, Isa, Isa, Aa, Isa, Isa, Isa, Isa, Gd^Es, Gd^Es, Rb, Isa, Ce, Rp, Rp, Rrc, Rp, Rrc, Ha, Rp, Ha, Rrc, Gd, Aa, Aa, Aa, Aa, Aa, Rb, Gd, Gd, Aa, Aa, Aa, Gd, Gd, Rb, Rb, Hhd, Ha, Ms, Md, Md, Md, Hhd, Md, Ha, Ms, Ms, Ms, Ms^Xm, Ms, Ms, Ms^Xm
Ms, Ms, Ms, Md, Md, Ms, Ms, Ms, Ms, Md, Wwg, Co, Wwf, Wwf, Gd^Vo, Isa, Rb, Rb, Isa, Isa, Rp, Rb, Aa, Rb, Aa, Rb, Rb, Rb, Wwg, Wwg, Wwg, Wwf, Co, Hhd, Md, Ha, Hhd, Aa, Aa, Aa, Gd, Aa, Gll, Gd, Aa, Aa, Gll, Aa, Aa, Gd, Gd, Rb, Aa, Aa, Hhd, Ha^Fp, Md^Xm, Ms^Xm, Hhd, Md, Hhd, Ha, Ha, Ms, Ms, Ms, Ms, Ms, Ms, Ms
Ms, Ms, Ms, Ms, Ms, Ms, Ms, Ms, Md, Md, Sm, Wwg, Wwg, Wwrg, Aa, Aa^Es, Rb, Rb, Rp, Rb, Gs, Aa, Aa, Rp, Aa^Vo, Aa, Rd, Gs, Coa, Ss, Hhd, Hhd, Ms, Md, Hhd, Hhd^Voa, Hhd, Gll^Feta, Aa, Aa, Gd, Gd, Aa^Fp, Gll, Gll^Es, Rb, Ce, Ce, Ce, Aa, Aa, Aa, Aa, Hhd, Ha, Md, Md, Chr, Hhd, Hhd, Ms, Ha^Fp, Md, Ms, Md^Xm, Ms, Md^Xm, Ms, Md^Xm, Ms
Ms, Ms, Ha, Ha, Ha, Ms, Sm, Ss, Ss, Rb, Wwg, Wwg, Ss, Co, Wwf, Aa^Esa, Wwf, Rb, Rp, Rp, Aa, Gd, Rb, Isa, Rd, Re, Wwg, Co, Wwg, Hhd, Hhd, Hhd^Fp, Ms, Ms, Hhd, Hhd, Hhd, Aa, Gd, Gll, Gd, Aa, Aa, Gd, Gd, Rb, Ce, Ce, Ce, Gd, Aa, Rb, Hhd, Hhd, Hhd, Hhd, Ha^Esa, Ha, Hhd, Ms, Ms, Md, Md^Xm, Md^Xm, Xu, Ms^Xm, Xu, Ms^Xm, Ms^Xm, Ms^Xm
Hh, Ha^Esa, Ai, Ai, Ai, Wwg, Ha, Ss, Hhd, Wwg, Sm, Ss, Ss, Wwg, Wwg, Wwg, Co, Co, Co, Re, Wwg, Re, Co, Rp, Co, Wwg, Wwg, Wwg, Hhd, Hhd, Ms, Ms, Ha, Hhd, Ha, Hhd, Gd, Gd, Aa^Voa, Gll, Gd, Gd, Gd, Gll, Aa, Rb, Ce, Ket, Ce, Aa, Aa^Fpa, Aa, Hhd, Hhd, Hhd, Hhd, Ha, Ha, Ms, Ms, Md, Md, Md, Xu, Uh, Xu, Uh, Md^Xm, Xu, Ms^Xm
Md, Ha, Md, Hhd, Ms, Ha, Ha, Hhd, Hhd, Hhd, Sm, Sm, Ss, Sm, Sm, Wwg, Wwg, Wwg, Wwg, Ss, Sm, Co, Wwg, Rb, Wwg, Wwg, Sm, Hhd, Hhd^Fpa, Md, Ms, Ms, Ha, Ha, Gd, Gd, Gd, Aa, Aa^Fpa, Aa, Gd, Gd, Gd, Aa, Aa, Rb, Rb, Ce, Gd, Aa, Aa^Fpa, Hhd^Fpa, Ha^Fp, Ha^Voa, Ms^Xm, Hhd, Hhd, Ha, Ms, Md, Ms^Xm, Ms^Xm, Xu, Uh^Vu, Cte, Cte, Cte, Uh, Xu, Xu
Ms, Ms, Ms, Ha^Esa, Ms, Ms, Md, Ha, Md, Hhd, Ha, Sm, Ha^Esa, Ss, Hhd, Ss, Hhd, Hhd, Hhd, Hhd, Hhd, Wwg, Hhd, Ss, Ha, Ha, Coa^Vo, Md, Md, Md, Ha, Ha, Ha, Hhd, Gll, Gd, Gd, Gll^Fp, Gll^Fpa, Gd, Gd, Gll, Gd, Aa, Gd, Gd, Gd, Rb, Gd, Gg^Fms, Gg^Fp, Hhd, Ha, Md, Md, Md, Ha^Fpa, Ha^Esa, Md, Md, Ms^Xm, Xu, Xu, Sm, Sm, Kte, Uu, Uu^Vu, Uu, Uu
Ha, Ms, Ha, Ha, Ha, Md, Ms, Ms, Ms, Ms, Ha, Hhd, Hhd, Aa^Fpa, Hhd^Voa, Hhd^Fp, Md, Md, Md, Hhd, Ha, Hhd, Coa, Hhd, Aa^Fms, Ms, Ha, Md, Hhd, Hhd, Hhd, Hhd, Gd, Gd, Rb, Rb, Gd, Gd, Gd, Gd, Gd, Gd, Aa, Aa, Aa, Gd, Aa, Rb, Gd, Gd, Gg^Fms, Hhd, Ha, Md, Ms, Ms, Md, Ha, Chr, Md, Ha^Esa, Ha, Uh, Uu, Uu, Cte, Uu, Uu, Uh, Uu
Hhd, Hhd, Hhd, Hhd, Md, Ms, Md, Ms, Md, Md, Ms, Md, Ms, Ms, Ms, Ha^Fpa, Md, Ms, Hhd, Md, Md, Md, Ha, Md, Ms, Ms, Ha, Hhd, Rb, Hhd, Gd, Gd, Gd, Gd, Rb, Rb, Re, Gd^Es, Rb, Gll, Gd, Gd, Aa, Aa^Vhr, Aa, Aa, Rb, Rb, Aa, Gd, Gll, Gd, Aa, Aa, Ms, Ms, Md^Xm, Ha, Ha, Hhd, Ha, Ha, Ms, Uh, Sm, Sm, Uh, Uu, Uh, Xu
Md, Ms, Ha^Esa, Hhd, Hhd, Md, Aa, Md, Ms, Ms, Ms, Ms, Hhd, Ms, Ha, Md, Hhd, Hhd, Hhd, Hhd^Vo, Ha, Md, Ha, Hhd, Hhd, Ha, Hhd, Hhd, Rb, Rb, Gd, Gd, Gd, Ha^Fp, Hhd, Hhd, Re, Gll, Rb, Rb, Rb, Gd, Gd, Gd, Rb, Rb, Aa, Aa, Gd, Gd, Gd, Gd, Aa, Hhd, Hhd, Md, Ms, Ha^Esa, Ha, Ha, Md, Ms, Xu, Uh^Vu, Uh, Uu, Uh, Uh, Xu, Xu
Md, Ms, Md, Hhd, Ms, Aa, Aa, Aa^Esa, Aa, Hhd, Md, Md, Ms, Hhd, Ha, Ha^Esa, Aa, Ha, Ha, Hhd, Ha, Ha, Rb, Hhd, Hhd, Ha, Aa^Esa, Rb, Gd, Gd, Gd, Gd, Gll, Hhd, Ha, Hhd, Gd, Gd, Gd, Gd, Gd, Gd, Rb, Rb, Gd^Es, Aa, Aa^Esa, Aa, Gd, Gd, Aa^Fpa, Gd, Hhd, Hhd, Hhd, Chr, Ms, Ha, Hhd, Ha^Fpa, Md, Ms^Xm, Ms^Xm, Xu, Ms, Xu, Xu, Xu, Xu, Xu
Ms, Ms, Ms, Md, Md, Ms, Ms, Ha, Ms, Ha, Ha, Ms, Ms, Ha, Gll, Gd, Gd, Gd, Gd, Rb, Rb, Rb, Rb, Re, Gll, Aa, Cer, Rb, Gd, Gd, Hhd, Gll, Gll, Hhd, Hhd, Hhd, Gd, Gd, Aa, Gd, Aa, Rb, Gd, Gd, Gd, Aa, Aa, Aa, Re, Rb, Aa^Esa, Aa, Gd, Hhd, Ha^Fpa, Hhd, Hhd, Hhd, Hhd, Ha^Voa, Ms, Ms, Ms^Xm, Ms, Ms^Xm, Ms^Xm, Ms^Xm, Xu, Ms^Xm, Ms^Xm
Ms, Ms, Ms, Ms, Ms, Ms, Ms, Ms, Ms, Ms, Hhd, Md, Hhd, Hhd, Gll, Gll, Hh, Gd, Ha, Gd, Cer, Rb, Gll, Gll, Gll, Aa, Gd, Gd, Ha, Hhd, Aa^Fpa, Ha, Ce, Gll, Ce, Ce, Gd, Aa^Es, Aa, Aa, Rb, Gll, Gd, Gd, Gd, Gd, Gd, Aa, Gg^Fp, Rb, Aa, Aa, Aa^Esa, Gd, Hhd, Hhd, Hhd, Hhd, Hhd, Ms^Xm, Ms, Ms, Md, Md, Md, Ms^Xm, Ms^Xm, Ms^Xm, Ms^Xm, Ms^Xm
Md, Ms, Ms, Ms, Ms, Ms, Md, Md, Ms, Ms, Ms, Ha, Aa^Esa, Gd, Gd, Gll, Ms, Gd, Hhd, Ha, Gd, Ker, Aa^Esa, Gll, Gll, Gd, Gll, Gd, Hhd, Hhd, Ha, Hhd, Ce, Ce, Ket, Ce, Aa^Fp, Aa^Fms, Aa^Vhr, Aa, Aa, Gll, Gd, Gll, Gd, Gd, Gll, Gd, Gd, Rb, Aa, Aa, Gd, Gd, Gd, Ha, Gd, Hhd, Hhd, Hhd^Fp, Md, Md, Md, Md, Md, Md, Md, Ms^Xm, Ms^Xm, Ms^Xm
Ha, Ms, Ms, Ms, Md, Md, Ms, Ms, Ms, Ms, Ha, Aa, Aa, Gd, Gd, Hhd, Ha^Esa, Ms, Ms, Hhd, Ha, Aa, Aa, Gll, Gll, Gll, Gd, Aa^Fpa, Ha, Hhd, Aa, Ha, Rb, Ce, Ce, Ce, Aa, Aa^Fp, Aa, Aa^Esa, Gd, Rb, Rb, Gd^Es, Aa, Aa, Aa, Gd, Gll, Gd, Gd, Gd, Gd, Gd, Aa, Gd, Gll, Hhd, Hhd, Hhd, Hhd, Ms, Ms, Md, Ms, Md, Ms, Md, Ms, Ms^Xm
Ha^Fpa, Ha, Ha, Md, Md, Ms, Ms, Ms, Ms, Ms, Ha, Ha^Esa, Hhd, Hhd, Gd, Ha, Ha, Ms, Hhd, Ha, Aa, Aa, Gd, Gd, Gd, Cer, Gd, Gd, Gd, Aa, Rb, Rb, Rb, Ce, Ce, Gd, Gd, Gd, Gd, Gd, Gd, Gd^Es, Gd, Rb, Aa, Aa, Aa^Esa, Aa, Aa, Gd, Gd, Gd, Gd, Aa, Aa, Aa^Esa, Aa, Gd, Gd, Hhd, Gll, Hhd, Ha^Esa, Ms, Chr, Md, Md, Md, Md, Ms
Ha^Fpa, Ha, Hh^Fma, Ha, Ha, Ms, Ha^Fp, Ha, Ha, Ha, Ha, Hhd, Ha^Fms, Hhd, Gd, Gd, Gd, Ha, Hhd, Hhd, Gg, Aa, Aa^Vhr, Aa^Esa, Gd, Gll, Gd, Gd, Gd, Gll, Gd, Gd, Gd, Gd, Gd, Gd, Gd, Gd, Gd, Gd, Rb, Gd, Gd, Gd, Gd, Aa, Gg, Aa, Gg, Rb, Gd, Gd, Gd, Gd, Gd, Aa, Gg, Aa, Gd, Gd, Gd, Hhd, Hhd, Ha, Ha, Ms^Xm, Ms, Md, Ms, Ms
