Mm, Mm, Mm, Mm, Mm, Mm, Ms, Gs, Mm, Gg, Ms^Xm, Gs, Mm, Rb, Ms^Xm, Ms^Xm, Ms^Xm, Ss, Hh, Wwg, Ha, Wwg, Wwg, Hh, Mm, Ms, Mm, Mm, Mm, Hh, Hh, Gll, Gd, Gll, Gd, Gd, Gll, Rb, Rrc, Rrc, Rp, Aa, Aa, Rb, Gd, Gd, Gll, Gd, Hh, Mm, Ms, Mm, Mm, Ms, Ms, Mm, Ms, Ms^Xm, Ms, Ms^Xm, Ms^Xm, Ms, Ms, Ms^Xm, Ms^Xm, Ms^Xm, Ms, Ms^Xm, Ms^Xm, Ms^Xm
Mm, Mm, Ms, Ms, Ms^Xm, Ms^Xm, Mm, Mm, Mm, Ms^Xm, Ms^Xm, Mm, Mm, Mm, Mm, Ms^Xm, Mm, Mm, Ms, Ha, Ha, Hh, Wwg, Hh, Ha, Ha, Mm, Mm, Mm, Hh, Hh, Aa^Esa, Aa, Gd, Gd, Gd, Gd, Gll, Gd, Aa, Gd, Rp, Rrc, Rrc, Gd, Gd, Gd, Gd, Hh, Ha, Ha^Esa, Mm, Mm, Mm, Ms, Ms, Ms, Ms, Ms, Ms, Ms, Ha^Esa, Ha^Esa, Ms^Xm, Ms, Ms, Ms, Ms, Ms^Xm, Ms^Xm
Ms, Ms, Ms, Ms, Ms^Xm, Ms^Xm, Mm, Mm, Mm, Ms, Ms, Ms, Mm, Mm, Wwf, Aa^Esa, Wwf, Ha, Ha, Ms, Ha^Esa, Hh, Wwg, Sm, Sm, Ha^Esa, Hh, Mm, Ms, Ms, Ha, Hh, Ha, Gd, Hh, Gll, Gd, Aa, Aa, Gd, Gd, Ce, Ce, Ce, Ce, Gll, Gd, Gd, Gd, Ha, Ha, Mm, Mm, Mm, Ms, Ms, Ms, Ms, Ms, Ms, Ms, Ha, Ha, Ha, Ms^Xm, Ms, Ms, Ms^Xm, Ms^Xm, Ms^Xm
Ms, Ms, Ms, Ms^Xm, Ms, Mm, Ms, Mm, Mm, Ms, Mm, Mm, Mm, Wwf, Mm, Wwf, Mm, Wwg, Wwg, Ha, Wwg, Ha, Ha, Wwg, Wwg, Ha, Hh, Ms, Ms, Ms, Ms, Mm, Mm, Ha, Hh, Gd, Gd, Aa^Esa, Gd, Aa, Gd, Ce, Ce, Ce, Ce, Aa^Esa, Gll, Gd, Gd, Gll, Gd, Hh, Mm, Ms, Ms, Ms, Ms, Ms, Ms, Ms, Ms, Ms, Ms, Ms^Xm, Ms^Xm, Ms, Ms, Ms, Ms, Ms^Xm
Ms, Ms, Ms, Ms, Ms, Ms, Ha^Fpa, Ha, Ha, Mm, Rr, Mm, Ce, Mm, Ce, Mm, Rrc, Co, Co, Wwg, Mm, Wwg, Wwg, Wwg, Co, Wwg, Hh^Fp, Ha^Fp, Mm, Mm, Ms, Ha, Ha^Esa, Hh, Hh, Hh, Hh, Gd, Gd, Gd, Aa, Gd, Gd, Ket, Ce, Aa, Gd, Aa, Aa, Aa^Fpa, Hh, Ha^Esa, Chr, Mm, Mm^Xm, Ms, Ms^Xm, Ms, Ms, Ms, Ha^Esa, Ms, Ms, Ms, Ms, Ms^Xm, Ms^Xm, Ms, Ms^Xm, Ms^Xm
Mm, Mm, Ms, Ms, Ms, Ms, Ha^Fpa, Ha, Rp, Ce, Ss, Rp, Rrc, Rrc, Rp^Em, Rrc, Rrc, Rrc^Vo, Rrc, Gd^Es, Rp, Coa, Co, Aa, Rb, Wwg, Wwg, Hh^Fp, Ha, Coa, Ms, Ha^Voa, Ha, Ha, Hh, Hh, Gll, Gd, Gd, Aa^Fpa, Aa^Fpa, Gd, Aa^Esa, Gd, Gd, Rrc, Rrc, Gd, Gd, Aa^Fpa, Gd, Hh, Hh, Hh^Fpa, Hh, Ha^Voa, Ms, Ms, Ms, Ha, Ha, Ha^Esa, Ha^Fpa, Ms, Ms, Ms^Xm, Ms^Xm, Ms^Xm, Ms, Ms
Ms^Xm, Mm, Ms, Ms, Ms, Ms, Aa, Aa, Rr, Rb, Ss, Ss, Wwf, Aa^Esa, Aa, Rb, Rb, Rrc, Rp, Rrc, Rrc, Rrc, Rrc, Rb, Rb, Co, Coa, Wwg, Hh, Ha, Ms, Ms, Ms, Ha, Hh, Gd, Gd, Gd, Gll, Aa, Aa, Aa, Aa^Fma, Aa^Fpa, Gd, Aa, Aa^Esa, Aa, Aa, Gd, Gd, Gll, Gd, Rb, Hh, Hh, Hh, Ms, Ha^Esa, Ha, Ms, Hh^Fpa, Ms, Hh, Ms, Ms, Ms, Ms, Ms, Ms
Ms^Xm, Ms^Xm, Ms, Ms, Mm, Mm, Mm, Cea, Rb, Ss, Sm, Sm, Sm, Wwf, Wwf, Rb, Coa, Co, Rp, Rb, Rrc, Rp, Aa, Rb, Rb, Co^Vo, Re, Wwg, Wwg, Hh, Hh^Fp, Ms, Mm, Ha, Hh, Hh, Gll, Aa, Aa, Aa, Aa, Aa, Aa, Aa^Fpa, Cer, Gd, Rp, Aa, Aa, Gd, Gd, Gll, Gd, Gd, Aa, Hh, Rb, Hh, Hh, Hh^Fpa, Ms, Ha, Hh^Esa, Ms^Xm, Ha^Fpa, Ms, Ms, Ha, Ms^Xm, Ms^Xm
Mm, Ms, Ms, Ms, Mm, Mm, Wwf, Ce, Rb^Es, Ss, Ss, Sm, Ss, Ss, Wwf, Wwf, Wwf, Co, Co, 1 Ko, Rp, Rp, Rb, Aa, Rrc, Rb, Gd, Co, Wwg, Wwg, Hh, Mm, Ms, Ha^Vo, Ha, Hh, Hh, Aa^Fpa, Aa, Aa^Esa, Gd, Gd, Gll, Gll, Aa, Rp, Rb, Re, Ce, Gd, Aa, Aa, Gd, Gd, Aa, Aa, Rb, Aa, Hh, Ms^Xm, Ms, Ha, Hh, Ms^Xm, Ha, Ms, Hh^Voa, Ms, Ms^Xm, Ms^Xm
Mm, Mm, Mm, Mm, Aa, Rb, Wwf, Rp, Wwf, Wwf, Sm, Sm, Ss^Vo, Wwf, Gd, Co^Vo, Co, Co, Ko, Coa, Co, Co^Vo, Rb, Gs, Rrc, Rrc, Gs, Wwg, Coa, Wwf, Wwf, Hh, Ms, Ms, Ms, Hh^Voa, Hh, Aa, Aa^Fda, Aa^Fpa, Gd, Gll, Aa^Voa, Aa, Aa, Rb, Rb, Ce, Ce, Ket, Aa, Aa^Fpa, Gll, Gd, Aa, Aa, Rb, Aa, Hh, Hh, Hh, Hh, Chr, Ms, Ms, Hh, Ms, Ha, Ms, Ms
Ms^Xm, Mm, Mm, Ms, Ms, Aa^Esa, Wwf, Ce, Wwg, Wwg, Wwg, Sm, Wwf, Wwf, Rp^Em, Coa, Rp, Co, Co^Vo, Co, Rp, Co, Rp^Es, Rb, Gd, Rrc, Gs^Es, Re, Aa, Co, Sm, Hh, Coa, Mm, Ms, Ms, Hh, Ha, Ha^Fpa, Aa^Fda, Aa, Gd, Gll, Aa, Aa, Rb, Re, Rb, Ce, Ce, Ce, Gd, Gd, Gd, Gd, Gd, Gd, Hh, Mm, Hh, Hh, Ha^Fp, Mm^Xm, Ms, Ms, Ms, Ms, Ms, Ms^Xm, Ms
Ms^Xm, Ms^Xm, Mm, Ms, Ms, Ms, Ms, Wwf, Wwg, Wwg, Co, Wwg, Aa, Rp, Rb, Rrc, Rp, 2 Ko, Gs^Es, Co, Coa, Rp, Rrc, Aa, Aa, Aa, Rrc, Gd, Aa, Co, Wwg, Hh, Hh, Mm, Hh, Hh, Hh, Hh, Gd, Gd, Gd, Aa, Gll, Gd, Rrc, Gd, Gd, Gd, Aa, Ce, Gd, Gd, Gd, Gd, Gll, Gd, Hh, Hh^Fp, Ms^Xm, Ms, Ha, Ms, Ms, Ms, Mm^Xm, Ms, Ms, Ms^Xm, Ms, Ms
Mm, Mm, Ms, Ms, Ms, Ms, Mm, Mm, Mm, Wwg, Wwg, Co, Aa, Rb, Rb, Rb, Aa, Rp, Rd, Coa, Rb, Rb, Gd^Vo, Rrc, Rrc, Re, Rb, Rrc, Rrc^Vo, Rrc, Rrc, Wwf, Rb^Em, Hh, Rrc, Hh, Rp, Gd, Rrc, Rp, Rp, Rp, Rp, Rrc, Gd, Gd, Gll, Aa, Aa, Aa, Aa, Gd, Gd, Gd, Rb, Hh, Ha, Ms, Ms^Xm, Ms, Ha^Esa, Ms, Ha^Esa, Hh^Fp, Ms^Xm, Ms, Ms, Ms, Ms, Ms
Mm, Mm, Mm, Ms, Mm, Ms, Ms, Ms, Ms, Sm, Wwg, Rb, Gs, Rb, Gs, Aa, Aa, Rrc, Rrc, Aa, Rrc, Rrc, Rrc, Rrc, Gd^Es, Gd^Es, Rb, Rrc, Ce, Rp, Rp, Rrc, Rp, Rrc, Ha, Rp, Ha, Rrc, Gd, Aa, Aa, Aa, Aa, Aa, Rb, Gd, Gd, Aa, Aa, Aa, Gd, Gd, Rb, Rb, Hh, Ha, Ms, Mm, Mm, Mm, Hh, Mm, Ha, Ms, Ms, Ms, Ms^Xm, Ms, Ms, Ms^Xm
Ms, Ms, Ms, Mm, Mm, Ms, Ms, Ms, Ms, Mm, Wwg, Co, Wwf, Wwf, Gd^Vo, Rrc, Rb, Rb, Rrc, Rrc, Rp, Rb, Aa, Rb, Aa, Rb, Rb, Rb, Wwg, Wwg, Wwg, Wwf, Co, Hh, Mm, Ha, Hh, Aa, Aa, Aa, Gd, Aa, Gll, Gd, Aa, Aa, Gll, Aa, Aa, Gd, Gd, Rb, Aa, Aa, Hh, Ha^Fp, Mm^Xm, Ms^Xm, Hh, Mm, Hh, Ha, Ha, Ms, Ms, Ms, Ms, Ms, Ms, Ms
Ms, Ms, Ms, Ms, Ms, Ms, Ms, Ms, Mm, Mm, Sm, Wwg, Wwg, Wwrg, Aa, Aa^Es, Rb, Rb, Rp, Rb, Gs, Aa, Aa, Rp, Aa^Vo, Aa, Rd, Gs, Coa, Ss, Hh, Hh, Ms, Mm, Hh, Hh^Voa, Hh, Gll^Feta, Aa, Aa, Gd, Gd, Aa^Fp, Gll, Gll^Es, Rb, Ce, Ce, Ce, Aa, Aa, Aa, Aa, Hh, Ha, Mm, Mm, Chr, Hh, Hh, Ms, Ha^Fp, Mm, Ms, Mm^Xm, Ms, Mm^Xm, Ms, Mm^Xm, Ms
Ms, Ms, Ha, Ha, Ha, Ms, Sm, Ss, Ss, Rb, Wwg, Wwg, Ss, Co, Wwf, Aa^Esa, Wwf, Rb, Rp, Rp, Aa, Gd, Rb, Rrc, Rd, Re, Wwg, Co, Wwg, Hh, Hh, Hh^Fp, Ms, Ms, Hh, Hh, Hh, Aa, Gd, Gll, Gd, Aa, Aa, Gd, Gd, Rb, Ce, Ce, Ce, Gd, Aa, Rb, Hh, Hh, Hh, Hh, Ha^Esa, Ha, Hh, Ms, Ms, Mm, Mm^Xm, Mm^Xm, Xu, Ms^Xm, Xu, Ms^Xm, Ms^Xm, Ms^Xm
Hh, Ha^Esa, Ai, Ai, Ai, Wwg, Ha, Ss, Hh, Wwg, Sm, Ss, Ss, Wwg, Wwg, Wwg, Co, Co, Co, Re, Wwg, Re, Co, Rp, Co, Wwg, Wwg, Wwg, Hh, Hh, Ms, Ms, Ha, Hh, Ha, Hh, Gd, Gd, Aa^Voa, Gll, Gd, Gd, Gd, Gll, Aa, Rb, Ce, Ket, Ce, Aa, Aa^Fpa, Aa, Hh, Hh, Hh, Hh, Ha, Ha, Ms, Ms, Mm, Mm, Mm, Xu, Uh, Xu, Uh, Mm^Xm, Xu, Ms^Xm
Mm, Ha, Mm, Hh, Ms, Ha, Ha, Hh, Hh, Hh, Sm, Sm, Ss, Sm, Sm, Wwg, Wwg, Wwg, Wwg, Ss, Sm, Co, Wwg, Rb, Wwg, Wwg, Sm, Hh, Hh^Fpa, Mm, Ms, Ms, Ha, Ha, Gd, Gd, Gd, Aa, Aa^Fpa, Aa, Gd, Gd, Gd, Aa, Aa, Rb, Rb, Ce, Gd, Aa, Aa^Fpa, Hh^Fpa, Ha^Fp, Ha^Voa, Ms^Xm, Hh, Hh, Ha, Ms, Mm, Ms^Xm, Ms^Xm, Xu, Uh^Vu, Cte, Cte, Cte, Uh, Xu, Xu
Ms, Ms, Ms, Ha^Esa, Ms, Ms, Mm, Ha, Mm, Hh, Ha, Sm, Ha^Esa, Ss, Hh, Ss, Hh, Hh, Hh, Hh, Hh, Wwg, Hh, Ss, Ha, Ha, Coa^Vo, Mm, Mm, Mm, Ha, Ha, Ha, Hh, Gll, Gd, Gd, Gll^Fp, Gll^Fpa, Gd, Gd, Gll, Gd, Aa, Gd, Gd, Gd, Rb, Gd, Gg^Fms, Gg^Fp, Hh, Ha, Mm, Mm, Mm, Ha^Fpa, Ha^Esa, Mm, Mm, Ms^Xm, Xu, Xu, Sm, Sm, Kte, Uu, Uu^Vu, Uu, Uu
Ha, Ms, Ha, Ha, Ha, Mm, Ms, Ms, Ms, Ms, Ha, Hh, Hh, Aa^Fpa, Hh^Voa, Hh^Fp, Mm, Mm, Mm, Hh, Ha, Hh, Coa, Hh, Aa^Fms, Ms, Ha, Mm, Hh, Hh, Hh, Hh, Gd, Gd, Rb, Rb, Gd, Gd, Gd, Gd, Gd, Gd, Aa, Aa, Aa, Gd, Aa, Rb, Gd, Gd, Gg^Fms, Hh, Ha, Mm, Ms, Ms, Mm, Ha, Chr, Mm, Ha^Esa, Ha, Uh, Uu, Uu, Cte, Uu, Uu, Uh, Uu
Hh, Hh, Hh, Hh, Mm, Ms, Mm, Ms, Mm, Mm, Ms, Mm, Ms, Ms, Ms, Ha^Fpa, Mm, Ms, Hh, Mm, Mm, Mm, Ha, Mm, Ms, Ms, Ha, Hh, Rb, Hh, Gd, Gd, Gd, Gd, Rb, Rb, Re, Gd^Es, Rb, Gll, Gd, Gd, Aa, Aa^Vhr, Aa, Aa, Rb, Rb, Aa, Gd, Gll, Gd, Aa, Aa, Ms, Ms, Mm^Xm, Ha, Ha, Hh, Ha, Ha, Ms, Uh, Sm, Sm, Uh, Uu, Uh, Xu
Mm, Ms, Ha^Esa, Hh, Hh, Mm, Aa, Mm, Ms, Ms, Ms, Ms, Hh, Ms, Ha, Mm, Hh, Hh, Hh, Hh^Vo, Ha, Mm, Ha, Hh, Hh, Ha, Hh, Hh, Rb, Rb, Gd, Gd, Gd, Ha^Fp, Hh, Hh, Re, Gll, Rb, Rb, Rb, Gd, Gd, Gd, Rb, Rb, Aa, Aa, Gd, Gd, Gd, Gd, Aa, Hh, Hh, Mm, Ms, Ha^Esa, Ha, Ha, Mm, Ms, Xu, Uh^Vu, Uh, Uu, Uh, Uh, Xu, Xu
Mm, Ms, Mm, Hh, Ms, Aa, Aa, Aa^Esa, Aa, Hh, Mm, Mm, Ms, Hh, Ha, Ha^Esa, Aa, Ha, Ha, Hh, Ha, Ha, Rb, Hh, Hh, Ha, Aa^Esa, Rb, Gd, Gd, Gd, Gd, Gll, Hh, Ha, Hh, Gd, Gd, Gd, Gd, Gd, Gd, Rb, Rb, Gd^Es, Aa, Aa^Esa, Aa, Gd, Gd, Aa^Fpa, Gd, Hh, Hh, Hh, Chr, Ms, Ha, Hh, Ha^Fpa, Mm, Ms^Xm, Ms^Xm, Xu, Ms, Xu, Xu, Xu, Xu, Xu
Ms, Ms, Ms, Mm, Mm, Ms, Ms, Ha, Ms, Ha, Ha, Ms, Ms, Ha, Gll, Gd, Gd, Gd, Gd, Rb, Rb, Rb, Rb, Re, Gll, Aa, Cer, Rb, Gd, Gd, Hh, Gll, Gll, Hh, Hh, Hh, Gd, Gd, Aa, Gd, Aa, Rb, Gd, Gd, Gd, Aa, Aa, Aa, Re, Rb, Aa^Esa, Aa, Gd, Hh, Ha^Fpa, Hh, Hh, Hh, Hh, Ha^Voa, Ms, Ms, Ms^Xm, Ms, Ms^Xm, Ms^Xm, Ms^Xm, Xu, Ms^Xm, Ms^Xm
Ms, Ms, Ms, Ms, Ms, Ms, Ms, Ms, Ms, Ms, Hh, Mm, Hh, Hh, Gll, Gll, Hh, Gd, Ha, Gd, Cer, Rb, Gll, Gll, Gll, Aa, Gd, Gd, Ha, Hh, Aa^Fpa, Ha, Ce, Gll, Ce, Ce, Gd, Aa^Es, Aa, Aa, Rb, Gll, Gd, Gd, Gd, Gd, Gd, Aa, Gg^Fp, Rb, Aa, Aa, Aa^Esa, Gd, Hh, Hh, Hh, Hh, Hh, Ms^Xm, Ms, Ms, Mm, Mm, Mm, Ms^Xm, Ms^Xm, Ms^Xm, Ms^Xm, Ms^Xm
Mm, Ms, Ms, Ms, Ms, Ms, Mm, Mm, Ms, Ms, Ms, Ha, Aa^Esa, Gd, Gd, Gll, Ms, Gd, Hh, Ha, Gd, Ker, Aa^Esa, Gll, Gll, Gd, Gll, Gd, Hh, Hh, Ha, Hh, Ce, Ce, Ket, Ce, Aa^Fp, Aa^Fms, Aa^Vhr, Aa, Aa, Gll, Gd, Gll, Gd, Gd, Gll, Gd, Gd, Rb, Aa, Aa, Gd, Gd, Gd, Ha, Gd, Hh, Hh, Hh^Fp, Mm, Mm, Mm, Mm, Mm, Mm, Mm, Ms^Xm, Ms^Xm, Ms^Xm
Ha, Ms, Ms, Ms, Mm, Mm, Ms, Ms, Ms, Ms, Ha, Aa, Aa, Gd, Gd, Hh, Ha^Esa, Ms, Ms, Hh, Ha, Aa, Aa, Gll, Gll, Gll, Gd, Aa^Fpa, Ha, Hh, Aa, Ha, Rb, Ce, Ce, Ce, Aa, Aa^Fp, Aa, Aa^Esa, Gd, Rb, Rb, Gd^Es, Aa, Aa, Aa, Gd, Gll, Gd, Gd, Gd, Gd, Gd, Aa, Gd, Gll, Hh, Hh, Hh, Hh, Ms, Ms, Mm, Ms, Mm, Ms, Mm, Ms, Ms^Xm
Ha^Fpa, Ha, Ha, Mm, Mm, Ms, Ms, Ms, Ms, Ms, Ha, Ha^Esa, Hh, Hh, Gd, Ha, Ha, Ms, Hh, Ha, Aa, Aa, Gd, Gd, Gd, Cer, Gd, Gd, Gd, Aa, Rb, Rb, Rb, Ce, Ce, Gd, Gd, Gd, Gd, Gd, Gd, Gd^Es, Gd, Rb, Aa, Aa, Aa^Esa, Aa, Aa, Gd, Gd, Gd, Gd, Aa, Aa, Aa^Esa, Aa, Gd, Gd, Hh, Gll, Hh, Ha^Esa, Ms, Chr, Mm, Mm, Mm, Mm, Ms
Ha^Fpa, Ha, Hh^Fma, Ha, Ha, Ms, Ha^Fp, Ha, Ha, Ha, Ha, Hh, Ha^Fms, Hh, Gd, Gd, Gd, Ha, Hh, Hh, Gg, Aa, Aa^Vhr, Aa^Esa, Gd, Gll, Gd, Gd, Gd, Gll, Gd, Gd, Gd, Gd, Gd, Gd, Gd, Gd, Gd, Gd, Rb, Gd, Gd, Gd, Gd, Aa, Gg, Aa, Gg, Rb, Gd, Gd, Gd, Gd, Gd, Aa, Gg, Aa, Gd, Gd, Gd, Hh, Hh, Ha, Ha, Ms^Xm, Ms, Mm, Ms, Ms
