Gs, Gs, Gs^Fms, Gs^Fds, Gs^Fds, Gs^Fds, Gs^Fds, Rb^Fdw, Re, Gd, Re, Gd, Gd, Gs, Gs, Gs, Gs, Gs, Gs, Gs, Gs, Hh, Hh, Hh, Hh, Hh, Hh^Es, Mm, Mm, Mm, Mm, Mm, Mm, Mm, Mm
Gs, Gs, Gs^Fds, Gs^Fds, Gs^Fds, Gs^Fds, Rb^Fdw, Rb, Rb, Re, Re, Gd, Gs, Re, Re, Re, Rd, Gs, Gs, Gs, Gs, Gs, Gs, Hh, Hh^Es, Hh, Hh, Mm, Mm, Mm, Hh, Hh, Mm, Mm, Mm
Gs^Fms, Gs^Fds, Gs^Fds, Gs^Fds, Gs^Fds, Rb^Fdw, Rb, Rb, Rd, Re^Edt, Re, Re, Rd, Re, Gd, Ce, Ce, Rb, Rb, Rd, Re, Gs, Gs, Gs, Hh, Hh, Hh, Hh, Hh, Mm, Hh, Mm, Mm, Mm, Mm^Xm
Hh^Fms, Gs^Fds, Hh^Fms, Gs^Fds, Gs^Fds, Rb^Fdw, Rb, Rd, Ce, Ce, Rd^Edt, Rd^Edt, Re^Edt, Re, Gs^Vct, Ke, Ce, Rb^Fdw, Rb^Fdw, Rb, Re, Rd, Gs, Gs, Hh, Hh, Mm, Hh, Mm, Hh, Mm, Mm, Mm^Xm, Mm^Xm, Mm^Xm
Hh^Fms, Hh^Fms, Rb^Fdw, Hh^Fms, Hh^Fds, Hh^Fdw, Rb, Gd, Ce, Ke, Rd, Rb, Gs, Gd, Rd, Ce, Re^Edt, Rb^Edt, Rb^Fdw, Rb^Fdw, Rb, Rd, Gs, Gs, Hh, Hh, Mm, Mm, Mm, Mm, Mm, Mm, Mm^Xm, Mm^Xm, Mm^Xm
Hh^Fms, Hh^Es, Hh, Hh, Hh, Hh^Fdw, Rb, Re^Vct, Rd, Ce, Re, Gs, Rd^Es, Rd, Re, Re, Re, Rb^Edt, Re, Rb^Fdw, Gg, Gg, Gs, Gs, Gs, Hh, Hh, Mm, Hh, Hh, Mm, Mm, Mm^Xm, Mm^Xm, Mm
Hh, Hh, Gd, Hh, Hh, Hh, Rd, Rd, Rd, Rd, Rd, Gs, Re, Rd, Re, Re, Gd, Gs, Gs, Gs^Es, Gg, Gg, Gg^Efm, Gs, Gs, Hh, Hh, Hh, Hh, Mm, Mm, Mm, Mm, Mm, Mm
Hh, Hh, Gs, Gd, Re, Gs, Re, Gd, Re^Es, Rd, Rd, Rd, Gs, Gd, Gd, Rd, Re, Gs, Gg, Gg, Gs, Gg, Gg, Gs, Gs, Hh, Hh, Hh, Mm, Mm, Mm, Mm, Hh^Vhh, Mm, Mm
Hh, Gs, Gs, Gs, Gd, Re, Re, Re, Gs, Gs, Rd, Gd, Rd, Gs, Gs, Re, Gs, Gs, Gg, Gg, Rb, Rd, Re, Gs, Gs, Gs, Hh, Hh^Es, Mm, Mm, Mm, Hh, Mm, Mm, Mm
Gg, Gg, Gs, Gs, Gs, Re, Re, Gd, Re, Rd, Re, Re, Re, Re, Re, Gs, Gg, Gg, Gg, Gs, Rb^Fdw, Rb^Es, Gs^Fds, Gs, Gd, Gd, Hh, Hh, Hh, Mm, Hh, Hh, Mm, Mm, Mm
Gg, Gg, Rb^Fdw, Rb^Fdw, Gs^Fms, Rb^Fdw, Rb^Em, Re, Re^Ecf, Re, Re, Gs, Gs, Re, Gs, Gs, Re, Gg, Gg^Efm, Gs, Gd, Gs^Fds, Gs, Gs, Gd, Gd, Gd, Hh, Hh, Hh, Hh, Mm, Mm, Mm, Mm
Gg, Gg, Gs^Fds, Rb^Fdw, Gs^Fms, Rb^Fdw, Rb^Fds, Re, Rb, Re, Ce, Gg, Gs, Rd, Rb, Rd, Re, Rd, Gd, Re, Re, Rd, Rd, Gs, Gs, Gd, Gd, Gd, Hh, Hh, Hh, Hh^Es, Hh, Mm, Mm
Gg, Gg, Gd^Em, Rb^Fdw, Gs, Rb, Rb^Fdw, Rb^Fdw, Rb, Gs, Ce, Ce, Gs, Rb, Rb^Fdw, Rb^Fdw, Rb, Rb^Fds, Rb^Es, Rb, Rb, Re, Ce, Ce, Ket, Gs, Gd, Gd, Gd, Hh, Hh, Hh, Hh, Mm, Mm
Gg, Gg, Rb^Fdw, Gs^Fms, Gs, Rb, Rb, Rb, Gs, Gg, Gg, Ke, Gs, Gs^Fds, Rb^Fdw, Rb^Fdw, Rb^Fds, Rb^Fds, Re^Fds, Rb^Fds, Re, Rb, Ce, Ce, Gs, Gd, Rd^Ecf, Gd, Gs^Es, Gd, Hh, Hh, Hh, Hh, Mm
Gs, Gg, Gg, Rb^Fdw, Gg, Gg, Gs, Gg, Gg, Gg^Vct, Gs, Gs, Hh, Rb, Rb^Fdw, Rb^Fds, Gs^Fds, Gs^Fds, Rb^Fms, Rb^Fms, Re, Gd, Gs, Gs^Vct, Rb^Es, Re, Rb, Gd, Gs, Gd, Re, Hh, Hh, Hh, Hh
Hh, Gs, Gg, Gg, Gg, Gg, Gs, Gs, Hh, Hh, Hh, Hh^Em, Hh^Fms, Gs^Vo, Rb, Rb^Em, Gs^Fds, Gs^Fds, Gs^Fds, Re^Fms, Rb^Fdw, Gd, Gs^Edb, Rb^Es, Rb^Dr, Re, Gs, Gs, Re, Rd, Gs, Re, Rd^Vhr, Hh^Emf, Wwr
Hh, Hh, Gs, Gs, Gg, Gs, Gs, Gd, Hh, Hh, Wwf^Es, Hh, Hh, Rb, Hh^Fms, Gs^Fds, Gs^Fds, Gs^Fds, Rb^Fds, Rb^Fds, Rb^Fds, Rb^Edb, Gs, Rb^Edb, Gs^Edb, Rd^Es, Re, Rd, Rd, Gs, Re, Gs, Hh^Emf, Wwr, Hh
Hh^Es, Hh^Es, Hh, Gs, Gs, Gs, Gd, Hh, Hh, Hh^Es, Wwf^Es, Hh, Hh, Gg^Fds, Hh^Fms, Gs^Fms, Gs^Fds, Rb^Fdw, Gs, Rb^Fdw, Rb, Rb, Re, Gs^Edb, Rd, Re, Wwf, Gs, Rd, Re, Rb, Re, Ww^Es, Wwr, Hh^Es
Gs^Fds, Hh^Fms, Hh^Fms, Gs, Gs, Gs, Rb^Fdw, Hh, Hh^Fdw, Hh^Fds, Wwf^Es, Rb^Fdw, Hh, Hh^Fds, Gs^Fds, Gs^Fds, Rb^Fdw, Gs, Re, Gs, Gs, Rd, Re, Rd, Re, Wwf, Hh, Wwf, Re, Re, Ww^Es, Ww^Es, Hh, Hh, Hh
Gs^Fds, Hh^Fdw, Hh^Fds, Gs, Gs, Gs, Rb^Fdw, Hh, Hh, Hh^Es, Hh, Wwf^Es, Ww^Es, Hh, Rb^Fdw, Rb^Fdw, Ker, Cer, Gs^Es, Re^Edb, Re, Gd, Rb, Re, Gs, Gs, Re, Wwf, Ww, Ww, Rb^Gvs, Hh, Hh, Hh, Hh
Rb^Fdw, Hh^Fds, Gs, Hh^Fds, Gs, Gs, Rb^Fdw, Rb^Fdw, Rb^Fdw, Hh, Hh, Rb^Fdw, Ww^Es, Hh, Gd, Rb^Fdw, Cer, Cer, Gs, Gd, Rb, Rb, Rb^Edb, Re, Rb, Gs, Gd^Vhr, Gll, Ww, Gd, Re, Hh, Hh, Hh, Mm
Gg^Fms, Rb^Fdw, Rb^Fdw, Gs, Gs, Gs, Rb^Es, Rb^Fdw, Gs, Gs, Gd, Hh^Emf, Hh, Ww, Ww, Gd, Gs, Gs, Gd^Edb, Gd^Edb, Rb^Edb, Re^Edb, Ker, Cer, Ww, Rb, Wwr^Edt, Ww, Rb, Re, Hh, Hh, Hh, Hh^Edt, Mm
Hh^Fds, Rb^Fdw, Gs, Gs, Gs, Rb^Es, Re^Dr, Rb, Gs^Vo, Re, Gs^Edb, Hh, Gs, Re, Re, Ww, Ww, Gd, Re^Edb, Re^Edb, Rb^Edb, Cer, Ww, Ww, Ww, Ww, Ww, Wwr^Edt, Rb, Gg, Hh^Fp, Gll^Fp, Mm, Mm, Mm
Hh, Hh, Rb^Fdw, Gs, Gd, Rb, Rb, Re^Es, Ce, Re^Edb, Gs^Edb, Gg^Edb, Gs, Re^Vhr, Gs, Gg, Rb, Ww^Edt, Ww, Re^Edb, Ww, Cer, Ww, Ww, Ww, Ww, Ww, Rb, Gs^Em, Hh, Hh^Fms, Gll^Fp, Mm, Mm, Mm
Hh, Hh, Hh, Hh, Gd, Rb^Ecf, Gd, Ce, Ke, Ce, Rb^Edb, Gs^Edb, Gd, Re, Re^Edb, Re, Rd, Gg, Ww, Re^Es, Ww, Ww, Wot, Wot, Wot, Ww, Ww, Gs, Hh, Hh^Fp, Hh^Fp, Hh, Mm, Mm, Mm
Hh, Hh^Fetd, Hh, Hh^Fdw, Gs, Gd, Gd, Ce, Gd, Rd, Rd, Rb^Edb, Rb, Rb, Gs^Edb, Gs^Edb, Rd, Gd, Ww, Ww, Ww, Wot, Wo, Wo, Wot, Wot, Ww, Re, Hh^Fp, Hh^Fp, Mm, Mm, Mm, Mm, Mm
Rb^Fdw, Hh, Hh, Gs, Gs^Eff, Gs^Eff, Gd, Gd, Re^Eff, Rb^Eff, Ww, Re, Rb, Gd, Re, Re, Gg, Rb, Wwr^Edt, Ww, Ww, Wot, Wot, Wo, Wo, Wot, Ww, Wwr, Hh^Fp, Hh^Fp, Hh, Mm, Mm, Mm, Mm
Rb^Fdw, Hh, Gs, Gs^Eff, Gs^Eff, Gs, Gs, Re, Gd, Gs, Re, Ww, Ww^Edt, Ww, Ww, Re, Ww, Ww, Ww, Rb, Gs^Vc, Ww, Ww, Wot, Ww, Ww, Ww, Wwr, Hh^Fp, Hh^Fms, Hh^Fms, Mm, Mm, Mm, Mm
Gs^Es, Rb^Fdw, Gs, Gs, Gg, Gg, Gd, Re^Vhr, Gd, Gd, Gs, Re, Rb, Gd, Rb^Fdw, Ww, Ww, Ww, Ww, Rb, Rb^Fdw, Rb^Fdw, Rb^Fdw, Ww, Ww, Ww, Ww, Ww, Ww^Es, Hh^Fp, Hh^Fp, Mm, Mm, Mm, Mm
Gs^Es, Gs, Gg, Gg, Gg, Gg, Gg, Gd, Gg, Gg, Re, Re, Gd, Rb^Fdw, Gd, Wwr, Ww, Ww, Ww, Ww, Ww, Ww, Ww, Ww, Ww, Ww, Ww, Ww, Ww, Hh, Mm, Mm, Mm, Mm, Mm
