Gs, Gs, Gs^Fms, Gs^Fds, Gs^Fds, Gs^Fds, Gs^Fds, Rb^Fdw, Re, Aa, Re, Gd, Aa, Gs, Aa, Aa, Aa, Gs, Gs, Gs, Aa, Ha, Hhd, Ha, Ha, Ha, Hhd^Es, Hhd, Ms, Ms, Ms, Ms, Ms, Ms, Ms
Gs, Gs, Aa^Fda, Aa^Fda, Gs^Fds, Gs^Fds, Aa^Fma, Rb, Rb, Re, Re, Aa, Aa, Re, Re, Re, Rd, Aa, Gs, Gs, Aa, Aa, Aa, Hhd, Ha^Es, Ha, Hhd, Ms, Ms, Ms, Ha, Ha, Ms, Ms, Ms
Gs^Fms, Aa^Fda, Gs^Fds, Aa^Fda, Aa^Fda, Aa^Fma, Rb, Rb, Rd, Re^Edt, Re, Re, Rd, Re, Gd, Ce, Ce, Rb, Rb, Rd, Re, Aa, Aa, Aa, Ha, Ha, Ha, Ha, Hhd, Ms, Hhd, Ms, Ms, Ms, Ms^Xm
Ha^Fms, Gs^Fds, Ha^Fda, Gs^Fds, Gs^Fds, Rb^Fdw, Rb, Rd, Ce, Ce, Rd^Edt, Rd^Edt, Re^Edt, Re, Gs^Vct, 2 Ke, Ce, Rb^Fdw, Aa^Fda, Rb, Re, Rd, Gs, Gs, Hhd, Hhd, Ms, Ha, Ms, Hhd, Ms, Ms, Ms^Xm, Ms^Xm, Ms^Xm
Ha^Fma, Ha^Fda, Aa^Fdw, Ha^Fda, Hh^Fds, Ha^Fpa, Rb, Gd, Ce, 1 Ke, Rd, Rb, Aa, Aa, Rd, Ce, Re^Edt, Rb^Edt, Aa^Fda, Aa^Fda, Rb, Rd, Aa, Aa, Ha, Hhd, Ms, Ms, Ms, Ms, Ms, Ms, Ms^Xm, Ms^Xm, Ms^Xm
Ha^Fma, Ha^Es, Ha, Ha, Ha, Ha^Fpa, Rb, Re^Vct, Rd, Ce, Re, Gs, Rd^Es, Rd, Re, Re, Re, Rb^Edt, Re, Rb^Fdw, Gd, Gd, Aa, Aa, Aa, Ha, Hhd, Ms, Ha, Ha, Ms, Ms, Ms^Xm, Ms^Xm, Ms
Ha, Ha, Aa, Ha, Ha, Ha, Rd, Rd, Rd, Rd, Rd, Gs, Re, Rd, Re, Re, Gd, Gs, Gs, Gs^Es, Gd, Gd, Gd^Efm, Aa, Gs, Ha, Ha, Hhd, Ha, Ms, Ms, Ms, Ms, Ms, Ms
Ha, Ha, Gs, Aa, Re, Gs, Re, Gd, Re^Es, Rd, Rd, Rd, Aa, Gd, Gd, Rd, Re, Aa, Gd, Gd, Aa, Gd, Gd, Gs, Gs, Ha, Hhd, Ha, Ms, Ms, Ms, Ms, Ha, Ms, Ms
Ha, Gs, Gs, Gs, Aa, Re, Re, Re, Aa, Aa, Rd, Gd, Rd, Aa, Aa, Re, Aa, Aa, Gd, Aa, Rb, Rd, Re, Aa, Aa, Gs, Hhd, Hhd^Es, Ms, Ms, Ms, Ha, Ms, Ms, Ms
Aa, Aa, Gs, Aa, Aa, Re, Re, Aa, Re, Rd, Re, Re, Re, Re, Re, Aa, Gd, Aa, Aa, Aa, Rb^Fdw, Rb^Es, Gs^Fds, Aa, Aa, Gd, Ha, Ha, Hhd, Ms, Hhd, Ha, Ms, Ms, Ms
Aa, Aa, Rb^Fdw, Rb^Fdw, Gs^Fms, Rb^Fdw, Rb^Em, Re, Re^Ecf, Re, Re, Gs, Gs, Re, Aa, Aa, Re, Aa, Gd^Efm, Aa, Gd, Gs^Fds, Gs, Aa, Aa, Aa, Aa, Ha, Ha, Hhd, Hhd, Ms, Ms, Ms, Ms
Aa, Aa, Aa^Fda, Rb^Fdw, Gs^Fms, Rb^Fdw, Aa^Fda, Re, Rb, Re, Cea, Aa, Gs, Rd, Rb, Rd, Re, Rd, Gd, Re, Re, Rd, Rd, Aa, Aa, Aa, Gd, Gd, Ha, Ha, Ha, Hhd^Es, Ha, Ms, Ms
Aa, Aa, Aa^Em, Rb^Fdw, Gs, Rb, Aa^Fda, Aa^Fda, Rb, Aa, Cea, Cea, Aa, Rb, Aa^Fda, Rb^Fdw, Rb, Aa^Fda, Rb^Es, Rb, Rb, Re, Cea, Cea, Kea, Aa, Gd, Gd, Gd, Ha, Hhd, Ha, Ha, Ms, Ms
Aa, Aa, Rb^Fdw, Aa^Fda, Gs, Rb, Rb, Rb, Aa, Aa, Aa, Kea, Aa, Aa^Fda, Rb^Fdw, Rb^Fdw, Rb^Fds, Rb^Fds, Aa^Fma, Aa^Fda, Re, Rb, Cea, Cea, Aa, Gd, Rd^Ecf, Aa, Aa^Es, Gd, Ha, Hhd, Ha, Ha, Ms
Gs, Aa, Aa, Rb^Fdw, Aa, Aa, Gs, Aa, Aa, Aa^Vct, Gs, Gs, Ha, Rb, Rb^Fdw, Rb^Fds, Gs^Fds, Aa^Fda, Rb^Fms, Aa^Fma, Re, Aa, Aa, Aa^Vct, Rb^Es, Re, Rb, Aa, Gs, Gd, Re, Hhd, Hhd, Ha, Ha
Ha, Gs, Aa, Aa, Aa, Aa, Gs, Gs, Ha, Ha, Ha, Ha^Em, Ha^Fma, Aa^Voa, Rb, Rb^Em, Aa^Fda, Aa^Fda, Gs^Fds, Re^Fms, Rb^Fdw, Gd, Gs^Edb, Rb^Es, Rb^Dr, Re, Aa, Aa, Re, Rd, Aa, Re, Aa^Voa, Ha^Emf, Wwr
Ha, Ha, Gs, Gs, Aa, Gs, Aa, Aa, Ha, Ha, Wwf^Es, Ha, Ha, Rb, Hhd^Fms, Gs^Fds, Gs^Fds, Aa^Fda, Rb^Fds, Aa^Fda, Aa^Fda, Rb^Edb, Aa, Rb^Edb, Gs^Edb, Rd^Es, Re, Rd, Rd, Aa, Re, Aa, Ha^Emf, Wwr, Ha
Ha^Es, Ha^Es, Ha, Gs, Gs, Gs, Aa, Ha, Ha, Ha^Es, Wwf^Es, Ha, Ha, Aa^Fma, Hhd^Fms, Aa^Fma, Gs^Fds, Rb^Fdw, Aa, Rb^Fdw, Rb, Rb, Re, Aa^Edb, Rd, Re, Ai, Aa, Rd, Re, Rb, Re, Ww^Es, Wwr, Ha
Ha^Fds, Ha^Fda, Ha^Fda, Aa, Gs, Gs, Rb^Fdw, Ha, Ha^Fdw, Ha^Fma, Ai^Es, Rb^Fdw, Ha, Hhd^Fds, Gs^Fds, Gs^Fds, Aa^Fda, Aa, Re, Aa, Aa, Rd, Re, Rd, Re, Ai, Ha, Ai, Re, Re, Ww^Es, Ww^Es, Ha, Hhd, Hhd
Ha^Fds, Hh^Fdw, Ha^Fma, Aa, Aa, Aa, Aa^Fda, Ha, Ha, Ha^Es, Ha, Ai^Es, Ww^Es, Ha, Rb^Fdw, Aa^Fda, Gd^Dr, Coa^Dr, Gs^Es, Re^Edb, Re, Gd, Rb, Re, Aa, Aa, Re, Ai, Ww, Ww, Rb^Gvs, Ha, Ha, Hhd, Hhd
Rb^Fdw, Ha^Fma, Aa, Ha^Fda, Aa, Aa, Rb^Fdw, Aa^Fda, Rb^Fdw, Ha, Ha, Rb^Fdw, Ww^Es, Ha, Gd, Rb^Fdw, Coa^Dr, Gd^Dr, Aa, Gd, Rb, Rb, Rb^Edb, Re, Rb, Aa, Aa^Voa, Aa, Ww, Aa, Re, Hhd, Hhd, Hhd, Ms
Gg^Fms, Rb^Fdw, Aa^Fda, Aa, Aa, Gs, Rb^Es, Rb^Fdw, Gs, Aa, Aa, Ha^Emf, Ha, Ai, Ai, Gd, Aa, Aa, Aa^Edb, Aa^Edb, Rb^Edb, Re^Edb, Aa^Dr, Coa, Ww, Rb, Wwr^Edt, Ww, Rb, Re, Hhd, Ha, Ha, Ha, Ms
Hh^Fds, Rb^Fdw, Gs, Aa, Gs, Rb^Es, Re^Dr, Rb, Aa^Voa, Re, Aa^Edb, Ha, Aa, Re, Re, Ww, Ai, Gd, Re^Edb, Re^Edb, Rb^Edb, Aa^Dr, Ai, Ai, Ww, Ww, Ww, Wwr^Edt, Rb, Aa, Ha^Fda, Aa^Fma, Ms, Ms, Ms
Ha, Ha, Aa^Fda, Gs, Aa, Rb, Rb, Re^Es, Cea, Re^Edb, Aa^Edb, Aa^Edb, Aa, Aa^Voa, Aa, Aa, Rb, Ww^Edt, Ww, Re^Edb, Ai, Coa, Ww, Ww, Ww, Ai, Ai, Rb, Aa, Hhd, Ha^Fda, Aa^Fma, Ms, Ms, Ms
Ha, Ha, Ha, Ha, Aa, Rb^Ecf, Gd, Cea, Kea, Cea, Rb^Edb, Aa^Edb, Gd, Re, Re^Edb, Re, Rd, Aa, Ai, Re^Es, Ai, Ww, Wot, Wot, Wot, Ai, Ai, Aa, Hhd, Ha^Fp, Hhd^Fma, Hhd, Ms, Ms, Ms
Ha, Ha^Fetd, Ha, Ha^Fda, Aa, Gd, Gd, Cea, Aa, Rd, Rd, Rb^Edb, Rb, Rb, Aa^Edb, Aa^Edb, Rd, Aa, Ai, Ai, Ww, Wot, Wo, Wo, Wot, Wot, Ww, Re, Hhd^Fp, Hhd^Fma, Ms, Ms, Ms, Ms, Ms
Rb^Fdw, Ha, Ha, Aa, Gs^Eff, Gs^Eff, Aa, Aa, Re^Eff, Rb^Eff, Ai, Re, Rb, Aa, Re, Re, Aa, Rb, Wwr^Edt, Ww, Ai, Wot, Wot, Wo, Wo, Wot, Ai, Wwr, Ha^Fda, Ha^Fda, Hhd, Ms, Ms, Ms, Ms
Rb^Fdw, Ha, Aa, Aa^Eff, Aa^Eff, Aa, Gs, Re, Gd, Gs, Re, Ai, Ww^Edt, Ww, Ww, Re, Ai, Ai, Ww, Rb, Aa^Voa, Ai, Ww, Wot, Ww, Ai, Ww, Wwr, Hhd^Fp, Ha^Fda, Ha^Fma, Ms, Ms, Ms, Ms
Aa^Es, Rb^Fdw, Gs, Gs, Gd, Gd, Gd, Aa^Voa, Gd, Gd, Aa, Re, Rb, Aa, Aa^Fda, Ai, Ai, Ai, Ww, Rb, Rb^Fdw, Aa^Fda, Aa^Fda, Ai, Ww, Ww, Ww, Ww, Ai^Es, Hhd^Fp, Hhd^Fp, Ms, Ms, Ms, Ms
Aa^Es, Aa, Gd, Gd, Gd, Gd, Gd, Gd, Gg, Aa, Aa, Re, Gd, Rb^Fdw, Gd, Ai, Ww, Ww, Ww, Ww, Ww, Ww, Ww, Ai, Ww, Ww, Ww, Ai, Ai, Hhd, Ms, Ms, Ms, Ms, Ms
